ataa 	!! ataa	! its underside, ventral area
ataa 	!! ataa	! its underside, ventral area of fish
aaġiak	! depression between shoulder blades
aaġiaq	! valley, pass (K)
aaġlu	! killer whale (Orcinus rectipinna) (K)
aaġlu	! tack
aaġluq	! killer whale (Orcinus rectipinna) (N)
aaŋ	! yes (N)
aahaaliq	! old squaw duck (Clangula hyemalis)
aakaga	! my mother (N,q)
aakauraġa	! my older sister (K)
aalġunaq	! menstruation
aanaaqłiq	! whitefish (big round nosed) (N)
aanaga	! my great aunt
aanaga	! my mother (K)
aanaga	! my grandmother (N,q)
aanaga	! my mother (K)
aanaruaġa	! my grandmother, great aunt (K)
aanaruaġiik	! grandchild living with grandmother
aanaruiñ	! suliuqpa savannah sparrow (Passerculus sandwichensis) (lit. what is your grandmother cooking?)
aanaruum	! kiviruq water ouzel (Cinclus Mexicanus) (lit. grandmother sank)
aanġuaq	! charm, amulet, idol (K)
aannaa!	! exclamation of pain, sorrow, disappointment
aannagu	! wait a minute! (N)
aannii	! exclamation of pain, sorrow, disappointment
aapaga	! my father (N, q)
aapaksraġa	! my stepfather
aapiyaġa	! my older brother
aaquaksraatchiaq	! old woman (K)
aaquaksraq	! old woman
aarigaa	! good! Fine!
aasii	! and, and then, (used consecutively, contrast with suli, which is used in an additive sense)
aasiiñ	! and, and then, (used consecutively, contrast with suli, which is used in an additive sense) (N, q)
aasiiñ-uvva	! and then this (introduces a change of subject)
aasivak	! spider (N, q)
aasrii	! and, and then, (used consecutively, contrast with suli, which is used in an additive sense)
aasriiñ	! and, and then, (used consecutively, contrast with suli, which is used in an additive sense) (K)
aasriiñ-uvva	! and then this (introduces a change of subject)
aasrivak	! spider (K)
aatauraġa	! my older sister (N)
aatchikkaaŋ	! danger! Exclamation of warning (K)
aatchuun	! gift
aatchuusiiq	! gift (received)
aatqatik	! mittens
aayuġaq	! perpendicular pressure ridge (K)
aġġiññaq	! knapsack, storage bag (N)
aġġitñaq	! knapsack, storage bag (K)
aġlu	! (1) jawbone (1)
aġluviñiq	! (1) bone runner piece (old time use) (1)
aġnaaluk	! big lady
aġnallautaq	! a pretty woman
aġnaq	! woman
aġnaqatiga	! my cousin (by my mother's sister)
aġnasalluq	! female (animal) (N, q)
aġnasralluq	! female (animal) (K)
aġnauraq	! little woman (i.e. girl)
aġra	! ashes
aġraqaġvik	! ash can
aġvak	! palm (K)
aġviġluaq	! gray whale (Rhachianectes leucas)
aġviq	! bowhead whale (Balaena mystecetus)
aññaġa	! my female cousin (female to female), my girlfriend (female of same age) (N,q)
aññaġiik	! female cousins, couple of girlsfriends
aŋaaluga	! my uncle (N)
aŋaayuliqsi	! pastor, missionary (N)
aŋaayuliqsi	! preacher (lit. one involved in praying)
aŋaayuliqsi	! minister, pastor (N)
aŋaayuliqsi	! preacher
aŋaayuqaułiq	! ruling power
aŋaayuqqaun	! greatness, kingdom (God's)
aŋaayyuliqiruat	! church (lit. praying ones) (N)
aŋaayyun	! prayer (N)
aŋaayyuvik	! church (building) (K)
aŋalaruti,	! afalatchisi authority, power
aŋalatchiľiq	! rule, reign
aŋalati	! director, governor, officer
aŋarrauraq	! cross (N)
aŋatchiaġa	! my uncle (mother's brother) (K)
aŋatkuġnaq	! medium, (communicates with the spirit world), (lit. resembling an afatkuq)
aŋatkuq	! shaman, medicine man, witch doctor
aŋauqaaġaitka	! my family
aŋayukłiaġruk	! two year old bull (K)
aŋayukłiġa	! my oldest child
aŋayukłiq	! two year old bull (N), one year old bull (K)
aŋayukłitqik	! three year old bull (N)
aŋayuqaaġiitchuaq	! orphan (K)
aŋayuqaaŋiḷauraq	! orphan (K)
aŋayuqaaq	! parent
aŋayuqaksraq	! old man
aŋayuqaq	! leader, boss
aŋŋun	! game animal
aŋiitchuq	! procures no game, fish (N)
aŋiłhisaun	! swing
aŋiqusaun	! temptation (kiv, q)
aŋiqusraun	! temptation (K)
aŋitqiksuq	! resuscitated again (of one shot and brought back to life again by an afatkuq), He arose again (of Christ)
aŋmaaq	! flint, chert, firestone (N)
aŋmaluaq	! lip-plug, labret
aŋmaun	! can opener (lit. opening tool)
aŋniq	! blizzard (K)
aŋniqsuq	! having a blizzard (K)
aŋugaatchiaq	! old man (K)
aŋugauraq	! small boy (K)
aŋun	! man
aŋuniaqti	! hunter
aŋusalluq	! male (animal (N, q)
aŋusralluq	! male (animal (K)
aŋutauraq	! small boy (N)
aŋutiqatiga	! my cousin (by my father's brother)
aŋuun	! paddle (single bladed)
aŋuun	! paddle, propeller
aŋuun	! fin (lit. paddle)
aŋuyałiq	! war (K, q)
aŋuyakti	! soldier, fighter (N)
aŋuyaun	! war (N)
aŋuyaunnat	! armor
aŋuyautairrun	! peace
aŋuyiuqti	! soldier, fighter (K)
agaayułiq	! prayer (K)
agaayuliqsi	! minister, pastor (K)
agaayuliqsi	! pastor, missionary (K)
Agaayun	! God (K)
agaayuviŋmuŋniaqtuŋa	! I'm on my way to church
agaayuvik	! church (building) (N)
agga	! across there (visible)
aggiqsuq	! comes (K)
aggun	! corruption (N)
agiaq	! file
agiksuq	! files, rubs (continually)
agiukpak	! perpendicular pressure ridge
aglaan	! but
aglagvik	! school desk, paper pad
aglagvik	! desk, writing pad
aglagviksraq	! paper, writing material
aglak	! mark, pencil line, letter of alphabet
aglaksruutit	! typewriter (K)
aglaun	! pencil
aglaun	! pencil (K)
aglautitaq	! typewriter
aglautitaqti	! typist (N)
aglautitaun	! typewriter (N)
aglautiti	! typist (K)
agliġuq	! lower jawbone (one side)
agliqquk	! lower jaw (mandible)
agliqquk	! lower jaw (both sides) (K)
agliqquk	! lower jawbone (both sides)
agliutraq	! picture (K)
agliutraq	! picture (K, q)
aglu	! (1) runner shoe (1)
aglu	! (8) runner (8)
agniq	! blizzard (N)
agniqsuq	! having a blizzard (N)
aguummaq	! basket (N)
ai	! what? Eh? Well? Okay?
aiġun	! cuff of a sleeve
aiñiq	! pocket
aimmaġvik	! home, household (N)
aimmaq	! basket (K)
aippaapak	! distant memorable past (N)
aippaavak	! distant memorable past (K)
aitchuun	! gift
aitchuusiaq	! gift (received)
aitqatik	! mittens (b)
Aitquyumagiñ.	! Tell her to come home!
aiviq	! walrus
aiḷiłiq	! noon meal (lunch) (K)
aiyauppiaq	! staff, walking stick
aiyugaaġun	! invitation
aki	! hook, gaff
akiaġaqtaaqtuk	! they (2) alternate
akiġuq	! branch (K)
akiñ	! pillow
akiisruk	! harlot (K)
akiitchualuk	! harlot (N)
akiitchuq	! lost (contest)
akiiḷaq	! debt
akikkak	! (5) fluke (5) (N)
akimiaġutaiḷaq	! fourteen (K)
akimiaŋŋutaiḷaq	! fourteen (N)
akimiaq	! fifteen
akimiaq	! atausiq sixteen (N)
akimiaq	! atausriq sixteen (K)
akimiaq	! malbuk seventeen
akimiaq	! pieasrut eighteen (K)
akimiaq	! pifasut eighteen (N)
akiľugaq	! echo (N)
akiqsruun	! promise, covenant (K)
akiruk	! are opposite (of 2)
akisi	! pillow (N)
akisułhaasugruktuaq	! that which is more valuable
akiḷiġaa	! paid it (lit. countered it)
akiḷiq	! reward
akiḷiun	! wage, price
akiḷiusiaksraqsi	! your future rewards (potentially received rewards)
akiḷḷiḷiqsuq	! opposes
akiyaun	! stretcher to carry things
akłaa	! Oh my! (having made a mistake) (N)
akłaq	! brown bear, grizzly bear (Ursus horribilis)
akłunaaq	! rope
akkaga	! my uncle (father's brother) (K)
akku	! a short while ago
akkuk	! (10) bottom formers (10)
akkupak	! immediately, right now (N)
akkupauraq	! a little while later (N)
akkuvak	! immediately, right now (K)
akkuvauraq	! a little while later (K)
akmaaq	! flint, chert, firestone (K)
aktilaaŋa	! its size
akuġluk	! bell (lit. instrument for repeated noise by striking)
akuġluk	! bell (an instrument to make repeated noise by hitting)
akuliaq	! nose bridge (K)
akunġak	! ridge between eyebrows
akunġanni	! among, in between
akuniq	! middle, between
akuq	! fancy fringe of parka (K), skirt (N)
akutuqpak	! broad-leafed plant
akutuqpalik	! leaf
alai	! exclamation of surprise (K)
alaqaa	! exclamation of sorrow
alġaaq	! afterbirth, placenta
alġaqsaq	! artifact
alġun	! dog soup pot
alianiułiq	! sorrow (K)
aliitchuq	! not lonely though living alone
alik	! tear, rip
aliqsik	! socks (K), caribou fur socks
alla	! another one, different one (N)
allatuun	! adultery, fornication
allimġaat	! lower molars
alliq	! bottommost
alluaq	! fishing or sealing hole
alluk	! both soles
alluutaq	! shoveler (Spatula clypeata)
alluvak	! seal's breather hole (suitable for placing net)
aluaq	! coal (N)
aluaqaġvik	! coal scuttle
aluġun	! sandal
aluq	! sole
aluutaq	! spoon
aluutauraq	! little spoon
amaaq	! root
amaġuq	! wolf (Canis lupus)
amaŋŋa	! from over there (N)
amai	! don't know (p)
amakŋa	! from over there (K)
amani	! located over there
amaniilik	! edible intestines (with fat, cooked)
amauga	! my great grandparent
amaułigaaluk	! snow bunting (Plectrophenax nivalis) (N)
amauligruaq	! common eider (Somateria mollissima)
amautligaq	! snow bunting (Plectrophenax nivalis)
amautlikkauraq	! snow bunting (Plectrophenax nivalis) (K)
amiġaiqsivik	! August (lit. caribou lost velvet) (K)
amiġaq	! bark
amiññiksraq	! radius
amiiqsuq	! he skins (it)
amiq	! skin
amiq	! hide, skin
amiq	! (13) skin covering (13)
amiqsuq	! covers a frame with skin
amiun	! thread for skins
amiun	! (12) thread for sewing skins together (12)
amiḷġaq	! ulna, fibia
amma	! over there, outside, downriver, then (somewhat distant in place or time, intermediate between uvva and imma)
ammun	! net rope
amna	! this one, that one (person or thing) (somewhat distant in place or time, intermediate between una and imea, or manna and imea)
amuŋa	! towards over there
anaġvik	! toilet, out-house
anaq	! stool (feces)
anaqapak	! tonight, this evening (N)
anaqavak	! tonight, this evening (K)
anaqsiuġayuk	! dung fly (Musea stercoraria)
anasriŋŋuqsaq	! punishment
anautaksraq	! hind upper leg (K)
anautaq	! axe, beating tool (upper hind leg)
anautaq	! hind upper leg (N)
anautaq	! axe (N)
anŋik	! sole patch (N, K)
anŋun	! (14) pitch (caulking) (14)
aniġniq	! breath
aniqatiga	! my sibling (my brother or my sister)
aniqatigiik	! sibling pair
aniu	! packed snow (N)
aniu	! any snow (K)
aniuvak	! snowbank
aniḷgitchuq	! exits again
anmukłaqtaqłuni	! go down quickly (as in flying)
annaa	! exclamation of pain, sorrow or disappointmentq
annaġniq	! bruise
annaun	! salvation (N)
Annaurri	! Savior (N)
anniġñaq	! pain (N)
annii	! exclamation of pain, sorrow or disappointmentq
anniqsuġiaq	! salvation
Anniqsuqti	! Savior
anniqsuqtiksraq	! salvation (K)
Anniqsuun	! Savior (K)
annuġaaq	! garment (N)
anuġivaalua	! wind's sound
anuksraq	! harness material
anuksraq	! harness webbing
anut	! harness (one or many)
anut	! (6) harness (6)
apai	! plenty! Enough!
Apiġigiga	! puttuqsritquvlusi. I ask that you be inspired
apiqsruun	! question
apqun	! trail
apuġaikutaq	! (10) front bow (10)
apuġun	! (11) front crosspiece (11)
apun	! snow
aputyaq	! snow patch
aputyaq	! snow block shelter (K)
apuyyaq	! snow block shelter (N)
apuyyaq	! snow patch
apyuq	! dust (K)
aqalgiq	! willow ptarmigan (Lagopus lagopus) (p)
aqaluk	! fish (n, kiv)
aqaluk	! fish (kiv, n)
aqalukpik	! trout, lake trout, arctic char (n, kiv)
aqaluksiuġayuk	! osprey (Pandion haliaetus) (lit. goes for fish) (n)
aqargigiaq	! Sabine's gull (Xema sabini)
aqargiq	! willow ptarmigan (Lagopus lagopus)
aqavirvik	! August (lit. moulting time) (N)
aqaya	! mud (N)
aqiaġuq	! stomach
aqiaġuq	! tree heart (stomach)
aqiaviñiq	! outter meat of body
aqiḷuqqaq	! soft snow
aqpaliuraq	! race, footrace (N)
aqpaliutraq	! race, footrace (K)
aqpallaiqsuq	! cannot run
aqpaq	! common murre (Uria aalge)
aqpaqsruqti	! sandering (Crocethia alba) (lit. runner)
aqpik	! Salmonberry, cloudberry (Rubus chamaemorus)
aqqauġaa	! angled a fish
aqsraatchaun	! high-kick ball
aqsraq	! ball
aqsravaluqtaq	! upper arm muscle (K)
aqu	! beaver (Castor canadensis) (K)
aqu	! back (stern)
aqu	! (6) stern (6)
aquani	! behind (lit. at its back)
aquġun	! (17) sled bag (17)
aqulliq	! last one, hindmost one
aqulliq	! sternmost
aquppiutaq	! chair
aquttuaq	! ship's pilot
aqvaluaq	! upper arm muscle (N)
arakaa	! comforts
argaak	! gloves
argaiġñaq	! mushroom (lit. don't handle)
argaich	! hand, fingers
argak	! finger
argigauraaq	! broken finger (N)
argiq	! roasting spit
argiqsuq	! cooks over open fire
arri	! likeness, parable
arrii	! exclamation of pain, sorrow, disappointment
arrii!	! exclamation of pain, sorrow or disappointment
arruk	! dampness around floor
asiaq	! berrry, fruit (q)
asiaq	! blueberry (Vaccinium uliginosum) (N)
asiavik	! blueberry (Vaccinium uliginosum) (q)
asik	! dear one
asiq	! sleeve
asriaq	! berrry, fruit (K)
asriavik	! blueberry (Vaccinium uliginosum) (K)
ataa	! hush! Be still!
ataani	! under
ataataga	! my grandfather, great uncle (N, q)
atai	! cute (of baby) (N)
atai	! exclamation of surprise (K)
atakkiataŋ	! because
atakkii	! because
atanġirrun	! liberty
ataniq	! leader, boss, master, president, king
Ataniq	! Lord
atanniqsuġaatin	! orders you to do it and you must do it
atanniułiq	! judgment (K)
atanniun	! judgment (K)
atanniutiksraq	! judgment to come (K)
ataraaq	! dress (K)
ataramik	! always
atausiq	! one (N, q)
atausisualuk	! only one
atausriq	! one (K)
atautchimiksuliguuq	! one more he said
atchaġniq	! easterly wind (noa, ki)
atchaga	! father's sister (K)
atchaga	! my aunt (N)
atchuu!	! I don't know! (N)
atiġa	! my namesake (relationship based upon sharing name of deceased person)
atiġiik	! two people with same name
atiġiik	! two people bearing same name
atigi	! pullover parka
atigitchiaq	! new parky
atikłuk	! parka cover
atiqayaqtut	! are almost the same
atiruk	! are identical (of 2)
atla	! another one, different one (K)
atniġñaq	! pain (K)
atnuġaaq	! garment (K)
atqasalik	! travels down wind
atqunaq	! plenty, abundant
atri	! likeness, parable
atta	! hush! Be still!
atuaġnaq	! northerly wind (not paralleling coast) (N)
atuŋak	! sole
atukkaŋa	! his song (singing)
atunim	! together
atuqtaksraq	! law (what ought to be done, used) (K)
atuqtuuraq	! musical instrument
atuqtuuraqti	! musician
atuun	! song
atuutluk	! evil magic-working song (K)
Atuyuitchuŋa.	! I sing poorly.
augavik	! blood vessel (N)
auk	! blood
auk	! igliqtuq blood flows
aukkun	! blood vessel (N)
auksałaq	! melting snow (K)
auksalaq	! melting snow
auksruaq	! red phalarope (Phalaropus fulicarius) (lit. blood-like)
auktaq	! mole, Mongolian spot (Mongol geburts fleck) (N, K)
aulasraun	! jigging stick
aullaqatigiiksut	! they depart together
aullaquvisigut	! do you want us to depart?
aullasiq	! habit, unconscious habit, instinct
aullasiq	! instinct
aulliq	! summer skin
auma	! charred wood, charcoal (K)
auma	! live coal
aumaraq	! charred wood, charcoal (N)
auniq	! rotten spot, rotting substance
aunniq	! rotten ice (unsafe)
aunniq	! rotten ice
auralliq	! summer skin (N)
auraq	! summer
autaaġaa	! divided it
avaŋŋa	! from afar off, from over there (N)
avakŋa	! from afar off, from over there (K)
avalliq	! the farthest over
avani	! located over there
avanmun	! toward each other (N)
avataaqtat	! framing lumber
avataliġuuvaq	! snow bunting (Plectrophenax nivalis) (p)
avataqpak	! float (buoy) (N)
avatmun	! toward each other (K)
avatraq	! (5) fluke (5) (K)
aviññaq	! mouse, vole (Microtus operarius), lemming (Synaptomys borealis) (K)
aviŋŋaq	! brown lemming (Lemmus trimucronatus) (N)
avilaitqan	! friend (N)
aviḷuqtaun	! bell (lit. instrument for repeated noise by striking)
aviḷuqtaun	! bell (an instrument to make repeated noise by hitting) (K, q, p)
avu,	! qapsitaaq sugar (K)
avuŋa	! towards there (over there)
avva	! far off (in place or time), over there (shoreward)
avvaq	! one half
avyuq	! dust (N)
aḷaqqaa	! exclamation of sorrow
ayaġruksaaġa	! my aunt (mother's sister)
ayaġun	! (4) bed crosspiece (4)
ayak	! post, pillar
ayak	! spear pole, whaling harpoon
ayauq	! boil (sore)
iġġiq	! mountain (N, q)
iġġuġviuraq	! wash basin
iġñiġa	! my son
iġñiksraġa	! my stepson
iġñitualuni	! his only son
iġñivik	! June (lit. birth time)
iġñivik	! birth time, month of June
ichuun	! plane, skin scraper (K)
ichuun	! skin scraper, plane (K)
iñġiq	! mountain (K)
iññiqun	! prowler (unknown person who is sometimes seen from afar and is blamed for otherwise inexplainable occurances)
iñiqtaġigaa	! made, created it
iñuaqti	! murderer
iñuŋŋuaq	! doll (lit.pretend person) (K)
iñuŋuluuraq	! little person, elf, dwarf
iñugaurat	! fingers (phalanges), four small toes
iñugaurat	! four small toes
iñuggun	! life (N)
iñugiaktillaqaqpalliqłutiŋ	! they being many, about. . .
iñugruiññaq	! mere man
iñuguġataqman	! when he finally grew up
iñuguqtitaq	! child raised but not adopted
iñuiñaġutaiḷaq	! nineteen (K)
iñuiñaq	! twenty (K)
iñuiñaq	! qulit thirty (K)
iñuiññaŋŋutaiḷaq	! nineteen (N)
iñuiññaq	! twenty (N)
iñuiññaq	! qulit thirty (N)
iñuitchuq	! there are no people
iñuk	! person, man
iñuk	! man (cf)
iñukitchuq	! are few
iñukkuksaivik	! July (lit. raising time) (N)
iñukpasrugruk	! giant (K)
iñuksraqtaaq	! chosen people
iñupiaq	! Eskimo (lit. real person)
iñupiatun	! Eskimo language (lit. like Eskimo)
iñuqun	! prowler (unknown person who is sometimes seen from afar and is blamed for otherwise inexplainable occurances)
iñuuŋŋuuraq	! doll (lit.pretend person) (N)
iñuułiq	! life (K)
iñuuniun	! medicine
iñuuqan	! one who is born on same day
iñuuqatigiik	! two born on same day (special friendship)
iñuuraqpak	! idol (N)
iñuusiq	! soul (immortal) (N,q)
iñuusriq	! soul (immortal) (K)
iŋaġiq	! black guillemot (Cepphus grylle)
iŋaluaqtaq	! umbilical cord
iŋaluat	! small intestines
iŋaluat	! intestines
iŋalugaaluk	! seaweed (Perphyra laciniata)
iŋaluk	! rain gear made from ugruk intestines
iŋatnaq	! toy (K)
iŋattaqtiqpaitchuq	! veers away, goes to excess
iŋilġaan	! indistinct past
iŋiqsrułiq	! prayer (K)
iŋiulik	! wave, swell
iŋiulikpak	! breaker on ocean (K)
iŋutaq	! hole for placing owl trap
iŋutuvak	! large whale with rolled blubber on back
igalaaq	! skylight (N)
igalauraq	! window (N)
igalġuraq	! glass (K)
igaliq	! skylight (K)
igaliq	! window (K)
iggaġri	! black bear (Ursus americanus) (N)
iggiaq	! gullet (esophagus)
igilaat	! (2) crosspieces (forming the platform) (2)
igimaq	! iron rod
igitaq	! abandoned baby
igitchivik	! garbage pail
iglaaŋuruŋa	! I am a traveler (K)
iglaaq	! traveller, stranger, visitor
igliġviksraq	! occasion, time for travel
iglu	! house (N), beaver dam (K, q)
iglukisaaksraq	! juggling pebbles
igniġuuqpatittuaq	! lightning (N)
igniġvik	! stove (N)
igniq	! fire (N)
igruŋnaq	! rose hip (K)
igurvik	! temporal
igutchaq	! bumble bee
igḷiġich	! rafters
igḷiq	! bench along the wall
igḷua	! the other one, next one
ii	! yes
iiguq	! high hill (N)
iiriġaq	! pill
iivaqsaat	! souls of the deceased going around and around (lit. rounding a bend) (K)
iłhuaġniq	! rainbow smelt (Osmerus dentex)
iłiq	! being, existence, presence (K)
iłuaġitchiiľiq	! respect
iłuammaaġiitchuq	! does not feel well (K)
iłuaqqun	! grace (lit. cause for what is right, good, correct) (K, q, n)
iłuiḷḷiiľiq	! affliction, agony (K)
iłuiḷḷiuġun	! discomfort, trouble (N)
iłummaaġiitchuq	! does not feel well (N)
iłuuqiñiq	! blackfish (Dallia pectoralis) (K)
ikaaqsaun	! (4) bed crosspiece (4)
ikagnaq	! north, northwesterly wind paralleling the coastline (N)
ikalġuq	! submerged sandbar
ikarraq	! hour (lit. a crossing place) (N)
ikaun	! bridging pole
ikautit	! bridge
ikayullapiaġaaŋa	! he helped me very much
ikiaqsiñ	! rip saw (K)
ikiipkuq	! foreleg (N)
ikik	! block of wood (vertebra)
ikipkaivik	! altar (in Bible) (lit. burning place)
ikiq	! vertebra (K)
ikiraalik	! square, cube
ikivġaq	! mattress, (lower of two caribou skins, fur facing down) ground sheet (K) (K)
ikłiġvik	! fox sparrow (Passerella iliaca) (lit. tool bag)
ikłiġvik	! tool kit (K)
ikkii	! icky, dirty
ikkiq	! irregular hard section in the tree rings (K)
ikniġvik	! stove (K)
ikniq	! fire (K)
ikniqpalik	! lightning (K)
iknisaiḷaq	! boreal or brown-capped chickadee (Parus hudsonicus)
ikpaitchiaq	! suitcase
ikpaksraaqamik	! three days ago
ikpaksraaqsugruk	! many days ago
ikpaksraq	! yesterday
ikpaksratqik	! day before yesterday
ikpiaġruk	! handbag (lady's)
ikpigaq	! set (foundation) of mind, where they come from (K)
ikpik	! cliff (where land slides are not possible)
iksivautaq	! chair (b)
iksriktaayuuq	! yellow wagtail (Motacilla flava)
iksriktaayuuq	! spotted sandpiper (Actitis macularia)
iksruuk	! testicles
iksuġaq	! (3) seat (3)
iktaq	! dump
ikuġutigiksut	! heather (Cassiope tetragona) (good fire starter)
ikun	! match
ikusik	! elbow (N)
ikusrik	! elbow (K)
ikuun	! skin scraper, plane (N)
ikuun	! plane, skin scraper (N)
ikuusuk	! wild celery (Angelica lucida) (K)
ikuvġaq	! mattress, (upper of two caribou skins, fur facing up) (N)
ilguq	! frostbite
iliŋich	! they (pl), them
iliŋik	! they, (two), them
ilipsi	! they (pl), them (K)
iliptik	! you (two) (K)
ilivsi	! they (pl), them (N)
ilivsik	! you (two) (N)
ilivsipsuuq	! you (pl.) too (K)
ilivsivsauq	! you (pl.) too
iluqaan	! everyone, all
ilvich	! you (N, K, q)
imaġruk	! big lake
imaksraq	! yeast
imaq	! water (undrinkable)
imavaalua	! water's sound
imña	! that one (remote in place or time)
imiġaq	! broth
imiñauraq	! prowler (unknown person who is sometimes seen from afar and is blamed for otherwise inexplainable occurances) (N)
imiñauraq	! fugitive (N)
imilġuq	! nose (N)
imiq	! water
imiq	! water (drinkable)
imiqaġvik	! water container with cover
imiqqaaġuktuŋa	! first I want to drink
imma	! there, then, when (very distant in place or time, beyond amma)
immaqtinniq	! puddle
immiġaun	! equipment for giving enema (of ugruk intestines)
immuk	! milk (N)
immulivik	! domestic cow (lit. milk place)
imnaġruich	! canyon (N)
imnaiq	! sheep, dall sheep (N)
imnaq	! cliff (where land slides are possible) (N)
imummak	! muskox (Ovibus moschatus) (K)
ini	! place, room
inikitchuq	! small place, room
iniqpak	! big place, big room
iniqpak	! city
inna	! thus, like this or that (N)
innasiq	! this way, that way (N)
ipi	! handle (of a bucket etc.)
ipiġaqtuun	! dog whip (q)
ipiġautaq	! axe (K)
ipiitaq	! fish line
ipkaq	! boiled ribs
ipnaġruich	! canyon (K)
ipnaiq	! sheep, dall sheep (K)
ipnaq	! cliff (where land slides are possible) (K)
ipqiłiq	! purity, holiness (K)
ipsuksaaq	! spring snare
ipu	! tool handle
ipun	! oar
ipuun	! oar
iqalugniaġusiptiktun	! like you have caught fish
iqalugruaq	! salmon, chum, humpback salmon (N)
iqaluk	! fish (N, q)
iqalukpik	! trout, lake trout, arctic char (N, q)
iqalusaaq	! whitefish (smallest) (N)
iqaqqun	! soap (N)
iqiq	! corner of mouth
iqirġaq	! corner
iqit	! fist
iqitquuraq	! little finger
iqittut	! they are flexed
iqłaq	! multipronged fishhook (K, q)
iqłu	! colon, large intestine
iqquliñ	! small pointed knife
iqquq	! buttock
iqsi	! prowler (unknown person who is sometimes seen from afar and is blamed for otherwise inexplainable occurances) (K)
iqsraġutilik	! Canada goose (Branta canadensis)
iqsraq	! cheek
iqsu	! dandruff
iquutiksraq	! toilet paper
iraiyayuuq	! shrike (Lanius excubitor) (lit. eye extractor)
irakumak	! iris of eye
iri	! eye
irigaak	! eye glasses
irigruak	! binoculars, goggles
irigruak	! binoculars
irisiñiq	! eye cavity
irrusiq	! personality, inner man, motive, spirit (K) (N,q)
irrusriq	! personality, inner man, motive, spirit (K) (K)
isaġulik	! angel (lit. supplied with wings) (N,q)
isaġuq	! wing (N)
isaġuq	! wing (N, q)
isatigich	! connecting cartilage ribs to breast bone
isavgaq	! young walrus
isiġvik	! fur ruff of parka
isiŋaiñŋaan	! before he entered
isiŋnaq	! jade
isiŋuatchauraq	! male whale
isigaich	! feet
isigaich	! napyaafich bones of toes (tarsals)
isigaich	! nugaurafich bone of foot (metatarsals)
isigak	! foot
isiq	! smoke in a building
isiqsivik	! prison, jail (K)
isivġiun	! judgment (N)
israġulik	! angel (lit. supplied with wings) (K)
israġuq	! wing (K)
isrugluk	! bone end (K)
isruma	! mind (K)
isuŋŋaġluk	! pomerine jaeger (Stercorarius pomarinus)
isuŋŋaq	! long-tailed jaeger (Stercorarius longicaudus)
isugluk	! bone end (N)
isuma	! mind (N, q)
isumanasi	! qaifanasuga don't think or thinking I have come
isummalluaġiitchuatiin	! you fool!
itcha	! on the other side, over there
itchaksralik	! 12' x 14' wall tent (lit. with six, meaning six panels long)
itchaksrat	! six
itchalik	! winter tent (N)
itchauraq	! mesentery apron
itchavik	! July (lit. moulting time) (K)
itchumauq	! may it be
itchumuuq	! may it be
itiġaq	! urine (K)
itiġiaq	! weasel (Mustela erminea)
itiq	! anus
itluk	! sling (K)
itna	! thus, like this or that (q, K)
itnasiq	! this way, that way (q)
itnasriq	! the like of, such kind (K)
itqiq	! gums
itqiq	! louse egg
itqirvik	! (17) sled bag (17)
itqiḷiq	! Indian
itqutaq	! breakfast (N)
itqutchiq-	! to eat breakfast (K)
itrisiun	! thermometer (K)
itrisriun	! thermometer (K)
ivalu	! sinew, thread
ivaluliñiq	! large back muscle
ivgich	! grass
ivgun	! napkin
iviktitaġaat	! puzzle
ivisaaq	! red stone (used for paint)
iviḷauq	! caribou fetus
iviḷuq	! clam, shellfish, bivalve, mussel, snail (N, q)
ivruiyaq	! green moss
ivrulik	! sod house
ivruqsiñ	! pickaxe (K, q)
ivsaiġutipkaq	! ice-bound boat
ivugaq	! pintail duck (Anas acuta)
ivugasrugruk	! mallard duck (Anas platyrhynchos)
ivuniġauraq	! little pressure ridge
ivuniq	! ice pressure ridge
iḷa	! relative by blood, marriage or name, companion, friend or partner
iḷaanni	! later, sometime (N)
iḷaanni	! sometime ( in future)
iḷaatni	! later, sometime (K)
iḷaŋa	! piibaa is subtracting (lit. its part he takes away)
iḷaknigiaqtuaq	! bride (K)
iḷalulasraaq	! whirlwind (K)
iḷannaq	! friend (K)
iḷaqataiqsuaq	! widow, widower, (lit.without a partner) (K)
iḷaqatiga	! my namesake's wife (K)
iḷaqatiga	! my partner (husband or wife) (K)
iḷaqatnigiaqtuaq	! bridegroom (K)
iḷaqatnigutlaiḷaq	! bachelor, spinster (K)
iḷari	! jellyfish
iḷarri	! lead dog, leader
iḷauraatka,	! ixatka my relatives
iḷaviñiq	! some (a part of something)
iḷiappak	! poor, orphan
iḷilgaaq,	! qitunbaq child
iḷisaqatigiiksut	! they teach each other
iḷisaurri	! teacher (N)
iḷisautri	! teacher (K)
iḷisiiḷaq	! one who casts spells (considered stronger than afatkuq)
iḷisimavich	! sumitilaaptifnik do you know where we live?
iḷitchitquraq	! disciple, learner (N)
iḷitchuġun	! cause of recognition, sign
iḷitchuq	! learns
Iḷitqusiġiksuaq	! Holy Spirit (lit. good spirit) (N)
iḷitqusiq	! spirit (N)
iḷitqusiq	! habit, happening, experience (q)
iḷitqusiq	! spirit (N)
iḷitqusiqłuk	! bad spirits (N)
iḷitqusriq	! habit, happening, experience (K)
iḷu	! inside, abdomen, stomach
iḷuaqtu	!  (puts it in, (makes a basket in basketball))
iḷummiq	! fetus
iḷummiq	! caribou fetus
iḷumun	! true, truth
iḷumutun	! true, truth
iḷupaaq	! inner fur clothing, underwear
iḷuqutaq	! porcupine (Erithizon epixanthum) (K)
iḷuvik	! grave (K)
iḷuvvivik	! grave (N)
iḷḷiaġutit	! comb
iḷḷuġa	! my cross-cousin, my joking partner (K, N)
iḷḷuk	! sling (N)
iyaġak	! stone, rock (K)
iyaġiłhaq	! knife sheath (K)
iyyaġriq	! black bear (Ursus americanus) (K)
kaagnaq	! famine
kaaksiuġun	! famine (N)
kaaviliuġun	! coffee pot (N)
kaŋiqsiñġitchuq	! understands not (K)
kaŋiqsitchaḷiraġai	! prevents then from understanding
kaŋiqsiḷḷagikpiñ	! I can understand you.
kaŋuq	! snow goose (Chen hyperborea)
kagapikkat	! backbone, spine (K)
kaivḷuun	! (1) stanchions (1)
kaivḷuutaq	! (21) handles (21)
kaivḷuutit	! (20) handle bar (20)
kakitḷaŋnaq	! wild rose (Rosa acicularis) (K)
kakiurat	! fork
kakkiaq	! fork
kakkiiyaun	! handkerchief
kakkik	! mucous
kakkiviaq	! groove under nose
kakkivik	! pincushion
kaliksiqsut	! tows one boat with another
kalluk	! thunder
kalluk	! coal (K)
kamaksriñiq	! obedience (N)
kamaksriŋitchuq	! disobeys
kamik	! mukluk, boot
kamikłuuk	! pants, trousers
kanaaq	! tibia
kanaŋŋa	! from down there (N)
kanagaq	! lower leg
kanagaq	! tibia
kanagnaq	! westerly wind
kanagnaq	! wind from downriver, from ocean (N)
kanakŋa	! from down there (K)
kanaknaq	! westerly wind
kanaknaq	! wind from downriver, from ocean (K)
kanakniġniqsuq	! wind blows from the downriver direction (K)
kanani	! located down there
kanayuq	! bullhead, sculpin (Oncocottus quadricornis)
kanayuuraq	! robin (Turdus migratorius)
kanŋuyaq	! copper (K)
kanigruaq	! frost on face, tree, etc.
kaniq	! frost
kanivaun	! diaphragm (N)
kanna	! down there, downriver, in front of
kannuyaq	! copper
kanuŋa	! towards down there
kanuŋiq	! diamond willow
kappugauraq	! scalpel (for blood letting) hypodermic needle
kappun	! scalpel (for blood letting) hypodermic needle
kapugauraitchuq	! extracted a splinter
kapugauraq	! splinter
kapusiut	! wooden shaft
karruutaq	! hammer (N)
kasimmavik	! meeting place
katchi	! wall
katitittuk	! marry
kaugun	! hammer (q)
kauk	! walrus skin (for food)
kautaq	! hammer (N)
kaviiłiq	! covetousness (K)
kaviqsaaq	! redness
kaviqsuaq	! northern sucker (K)
kavisiq	! fish scale
kavitchich	! scales
kaviuqqun	! covetousness (N)
kavlaq	! bearberry (Arctostaphylos alpina)
kavraq	! wounded caribou that runs away while unobserved
kavraq	! crown of head (skull cap) (N)
kavviaq	! red fox (K)
ki	! do it! Say it! Proceed!
kia	! whose?
kiasik	! shoulder blade (scapula)
kiasik	! shoulder blade
kiña	! who?
kiŋmautik	! pliers (N)
kiŋuvaatka	! my ancestors
kiggisik	! pliers (K)
kigiñaq	! face (K)
kigipigaq	! backbone
kigiyuk	! white-fronted goose (Anser albifrons) (K)
kiglu	! (8) bow deck (8)
kigun	! tooth
kigunniq	! box
kigusriqutit	! tooth brush
kigutaiqsuq	! pulls his own tooth
kigutit	! teeth
kigvaluk	! muskrat (Ondatra zibethicus) (K)
kii	! do it! Say it! Proceed!
kiiġuyat	! northern lights, (Aurora borealis) (K)
kiiñaaq	! male seal in mating season
kiiñaġuq	! mask
kiiñaq	! face (N, q)
kiiguraq	! (5) outside stringer (5)
kiikkaa	! do it! Say it! Proceed!
kiiqsiuġun	! pain
kiiraq	! crease, corrugation
kiirauraq	! scallop, clam
kiiriq	! Canada jay, camp robber (Perisoreus canadensis)
kiisaimma	! finally, at last
kikiak	! nail
kikmiññaq	! lowbush cranberry (Vaccinium vitis idaea) (K)
kikmik	! heel (K)
kikmitquq	! back of leg (K)
kiksraq	! a path cut through brush or trees
kiktuġiaq	! mosquito
kiktuqsralik	! ant
kilalugak	! beluga whale (Delphinapterus leucas) (N)
kilgun	! warning
killalik	! white-winged scoter (Melanitta deglandi)
killiġuaq	! joiner (K)
killiqiri	! sinner, wrong doer (K)
killukun	! mistake
killuliqiri	! sinner, wrong doer
killuq	! error, crime, sin
kiluagnaq	! east, southeasterly wind (N)
kiluisaq	! lock
kiluitchaq	! lock (N)
kiluk	! stitch
kiluusaq	! lock (K)
kimŋutit	! rake
kimmik	! heel (N)
kimmitquq	! back of leg (N)
kinataġun	! (19) sled brake (19)
kiniġniq	! hip joint
kiniġniq	! femur
kiniksuq	! kisses
kinnaq	! fool
kinnaum	! nigafa rainbow (a)
kipakłiqsuq	! mocks (N)
kipluun	! cross-cut saw (K)
kipmiŋnaq	! lowbush cranberry (Vaccinium vitis idaea) (sh)
kipmik	! heel (q)
kiptaitchuq	! bright child, fully awake
kirgavaitchauraq	! gnat, "no-seeum" (colored like a hawk)
kirgavik	! goshawk (Accipiter gentilis), peregrine falcon (Falco peregrinus)
kisaq	! anchor (K)
kisima	! I alone
kisimi	! he alone
kisipigaq	! backbone (K)
kisisaq	! grounded ice pile (keeps landlocked ice from floating away), floeberg
kisivich	! you alone
kisum	! whose? (K)
kita	! ready!
kitchaq	! anchor (N)
kiuġuyat	! northern lights, (Aurora borealis) (N)
kivaknak	! wind from upriver (K)
kivaknaq	! east, southeasterly wind (K)
kivaknaq	! easterly wind (K)
kivakniġniqsuq	! wind blows from the upriver direction (K)
kivgaluk	! muskrat (Ondatra zibethicus) (N)
kivgaq	! servant, messenger
kivluun	! cross-cut saw (N)
kivva	! there (inwards, visible), (upriver, inland)
kivva	! upriver, inland, further inside
kivviġruaq	! caribou appendix
kiḷigvak	! mammoth, mastadon (N)
kiḷḷiq	! cut
kukiilik	! hoof (fingernail) (N)
kukik	! nail (finger, toe, claw)
kukik	! hoof (fingernail) (K)
kukkiḷiñ	! toothpick
kulavagraitchiaq	! large cow
kulavagruitchauraq	! very old skinny cow (N, n)
kulavak	! caribou cow
kulavauraq	! young cow before conceiving (in 2nd year)
kuliq	! (1) gunwhale (1)
kumaarat	! beans
kumak	! louse, larva of the caribou bot fly
kunik	! kiss
kuniun	! nose tip
kurugaq	! pintail duck (Anas acuta) (N)
kusriqsuq	! drips (K)
kusrugaqtuġvik	! February (lit. icicle time) (K)
kusrulugaq	! icicle
kutchiñaaq	! whole pelvis (N)
kutchik	! pelvis (one side) (N)
kutchinġaat	! small of back (lumbar curve)
kutchiq	! hip bone (ossa coxae) (N)
kutchuq	! resin, spruce gum, chewing gum
kuuġuq	! tributary river
kuuġuuraq	! creek
kuugaatchiaq	! rivulet linking a lake to river
kuuk	! river
kuukpiaq	! coffee
kuukpiaqtuġvik	! coffee pot (K)
kuukukiaq	! common snipe (Capella gallinago)
kuutchiñaaq	! whole pelvis (K)
kuutchik	! pelvis (one side) (K)
kuutchiq	! hip bone (ossa coxae) (K)
kuvlu	! thumb
kuvluġuq	! dew claw
kuvraq	! net, fishing net
kuyaaq	! (9) keel (9)
kuyapigaurat	! block and tackle
kuyapikkat	! backbone (N)
kuyipikkat	! backbone, spine (N)
livilivillakpak	! semipalmated sandpiper (Ereonetus pusillus)
livilivillauraq	! least sandpiper (Erolia minutilla)
maakŋa	! from around here
maani	! around here
maani	! here
maatnagu	! wait a minute! (K)
maatnugu	! wait a minute! (K)
maġġaq	! sand
maŋaqtaaq	! light grayness
maŋŋuq	! foundation
makitiqłuni	! immediately getting up
makkaq	! diaper
makkatqiksuq	! changes diapers
makpiġaaq	! page, sheet of paper
makpiġaat	! book (lit. papers)
maktak	! whale skin with blubber (N, K)
makua	! these here
makuak	! these two
makunaŋŋa	! from these (N)
makunakŋa	! from these (K)
makunani	! at these
makuniŋa	! with these
makunuŋa	! to these
makunuuna	! through these
malġi	! pacific arctic loon (Gavia arctica pacifica)
malġuk	! two
malġukipiaq	! forty
malġukipiaq	! qulit fifty
maliġuaqti	! disciple, learner (K)
maliġutaksraq	! law (what ought to be followed) (K)
mamaaq	! (2) gums, material holding baleen (2)
mamaitchuq	! smells strong, smells foul (K)
mamaiḷaq	! sulfur (K)
mamaun	! udder
mamilik	! Eskimo waterproof boots (K)
managaaraq	! steep rise
manaq	! hook (multipronged) for retrieving seal, a fishing tackle for jigging tomcod (N, q)
manik	! money
maniq	! tussock (moss used with stove lamps), clump grass
manna	! this one around here
mannik	! egg
mannium	! saunifa egg shells (lit. egg's bones)
mapsa	! pancreas
mapsaq	! snowdrift overhang (ready to fall) (K)
maptak	! whale skin with blubber (q)
maptiġaq	! sod house (K)
masrik	! gills
masru	! Eskimo potato (K)
masu	! Eskimo potato (N, q)
masu	! aibaq edible root, Parry's Wallflower (Parrya nudicaulis)
masuqutaq	! plant of Eskimo potato
matchaaq	! oatmeal (N)
matun	! like this one here
mauŋa	! hither
mauna	! through here
maunaq	! trap entrance
mauragaq	! small ice pan used as stepping stone
mauyaq	! break through snow condition
mavsa	! snowdrift overhang (ready to fall) (N)
mayuaġautit	! stairs, ladder, steps (N)
mayuaġautit	! ladder, stairs (N)
mayuqtaq	! ladder, stairs (K)
miġiaqsaayuk	! parasitic jaeger (Stercorarius parasiticus) (lit. goes for vomit)
miñik	! splash (from a fish or thrown object)
miñugluk	! stain, spot
miŋuaqtuun	! pencil (N)
miillaq	! soap (K)
mikigaq	! blubber strips aged in seal skin poke
mikilġaq	! ring finger
milluk	! both breasts
milu	! nipple
milugaitchiaq	! tiny mosquito, "white socks"
milugiaq	! northern sucker (s)
miluk	! breast, nipple, milk (K)
miluk	! milk
miluk	! nipple
miluyuuq	! caribou bot fly (Oedemagena tarandi)
minġuiqsiġvik	! Sunday, Sabbath
minġuiqsiłiq	! Sunday, Sabbath (K,q)
minġuiqsiľiq	! Sabbath (K)
minŋiqsuq	! jumps
minŋuq	! beetle
miqsruun	! needle (N)
misiġaaq	! meat dip of sea mamml oil (N)
misikaaġaq	! black-capped chickadee (Parus atricapillus)
misikaaqqauraq	! black-capped chickadee (Parus atricapillus)
misiksuq	! leaps straight up, jumps down from low height
misruġuq	! juice, kool aid, wine (K)
misruligruaq	! sleet (K)
misrulik	! sleet
misuġuq	! juice, kool aid, wine (q)
misuktaun	! fountain pen
misulik	! sleet (N)
mitaiḷaq	! soft snow on ice floe covering an open spot
mitchaaqqammiqsuq	! just landed
mitilugruaq	! emperor goose (Phillacte canagica)
mitiq	! duck (q)
mitlik	! carving tool
mitqun	! needle (K)
mitquq	! hair (piece of fur)
mitquq	! feather (fur, body hair)
mitqut	! body hair, pubic hair
mitqutailḷaq	! arctic tern (Sterna paradisaea) (lit. without needle)
mitqutaiḷaq	! arctic tern (lit. is without a needle)
miḷik	! very soft snow
miḷuqataiqsivik	! September (lit. leaves falling) (kiv)
muġałłiq	! slush ice
mukkaaq	! flour (K)
mulik	! diaphragm (K)
mumiġnaq	! tree stump
mumiksuq	! turns over, changes, repents
mumiksuq	! changes, turns over, repents (K)
mumiľiq	! repentence (K,q)
mumiq	! hind leg, hind quarter
muqpaaraq	! biscuit
muqutipkaq	! ice-bound boat
naaġaayiq	! wood frog (Rana sylvatica)
naagga	! no! (emphatic), or (N, q)
naami	! where at
naataq	! great gray owl (Strix nebulosa)
naataqpak	! barred owl (Strix ulula)
naġiaq	! bait
naŋinnaq	! hell (suffering) (K)
naŋirrun	! disease
naŋirvik	! hospital (lit. place for sick ones)
naglikkun	! mercy
nagliksaaġvik	! hell (place of suffering) (N)
nagliksaun	! affliction, suffering
nagliktaq	! pity, grace, mercy, love (K)
nagliktuun	! mercy (N)
nagliktuutiqpak	! grace
nagliktuutiqpak	! grace (N)
nagruk	! antlers (horns)
nakasruk	! bladder (K)
nakasuk	! bladder (N)
nakiñi	! where from
nakuaqsriun	! love
nalaulġataqtillugu	! till it is right
nalautirrun	! gunsight
nalġuqsruun	! discipline, correction (K)
naluaġmiu	! white person
naluaq	! bleached seal skin
nalukataq	! blanket toss
nalunaiñŋutaq	! mark, seal
nalupqisun	! doubt
nanġaun	! praise, honor
nani	! where? (K)
naniġiaq	! trap
naniġuun	! flashlight (K)
naniq	! lamp
nanmakti	! donkey (lit. burden bearer) (N)
nanmaun	! dog pack
nanuq	! polar bear, (Thalarctos maritimus)
nanuun	! ointment
napaaqtum	! aqargiq hudsonian spruce grouse (lit. spruce ptarmigan) (Canachites canadensis)
napaaqtum	! qipmiurafa spruce cone (K), (lit. spruce's puppy)
napaġiaq	! upright (vertical)
napaġiaq	! (3) upright (3)
napaqti	! mast
naplu	! knee joint (K)
napmun	! where to
naqaaġuurut	! patch of swamp grass
naqitaaġun	! (13) tie-down rope (13)
naqitaqpik	! (4) rope tie-downs (4)
naqittaġun	! (3) rope lashes (3)
narraaġiitchuq	! stomachache (chronic)
narraq	! abdomen
narvaq	! lake
nasaġauraq	! kerchief (N)
nasaq	! hood (N)
nasautaq	! cap (N)
nasautaqłuk	! old hat
nasraġaq	! kerchief (K)
nasraq	! hood (K)
nasraun	! cap (K)
nasritchuq	! ascends to a high spot for scanning (K)
nataaġnaq	! flounder
natatquġnaq	! hailstone
natchiaġruk	! seal-skin trousers
natchiksuq	! yearns to follow
natchiq	! hair seal
natiġnaq	! flat tundra
natiġvik	! snowdrift
natiġviksuq	! snow is ground drifting
natiq	! valley floor
natiq	! floor (lake bottom, valley floor)
natiq	! bottom
natkikkaa	! correction
natmakti	! donkey (lit. burden bearer) (K)
natqiksruun	! discipline, correction (N)
nauŋ	! where? (N)
naukun	! by which way, how
naumi	! no! (N, sh)
naunġat	! young tree growing from old root
nautchiaq	! flower
nautchiaqaġvik	! garden
nautchiaqaġvik	! garden, field
nauyaq	! gull
nauyatchiaq	! mew gull (Larus canus) herring gull (Larus argentatus)
nauyavasrugruk	! glaucus gull (Larus hyperboreus)
navlu	! knee joint (N)
nayaŋŋak	! common scoter (Oidemia nigra)
nayuutigaa	! brought it up (climbed up with it)
niaquq	! skull, head
niaquq	! head
niaquq	! head, skull
niaquqtuaġruk	! hawk owl (Surnia ulula)
niġġivik	! table (lit. eating place)
niġiñiaqtugut	! we will eat
niġiniutnaq	! table knife (K)
niġisuŋnaq	! famine (K)
niġityaġiñ	! would you come to eat!
niġivaallukkiga	! first time I eat it
niġiḷiktaq	! Adam's apple (larynx)
niġliġnaq	! pacific black brant (Branta nigricans) (K)
niġlinġaq	! pacific black brant (Branta nigricans) (N)
niġlivaiḷuk	! white-fronted goose (Anser albifrons) (N)
niġukkaq	! stomach with contents, anything in the abdominal cavity
niŋauga	! my brother-in-law, my son in-law
nigaq	! snare for caribou and sheep
nigaq	! rainbow (K)
nigatchiaq	! rainbow (N)
nigatchiaq	! snare (for small game)
nigavik	! haunch
nigiq	! north, northeasterly wind
nigiqpaq	! north, northeasterly wind
nikaitchuq	! perseveres, does not give up
nikaitchuq	! keeps trying, determined
nikaliqsuq	! gives up (K)
niksik	! hook, fishhook, lure
niksikpak	! (7) anchor (7)
niliq	! flatus
nimiġiaq	! water worm, eel, serpent, snake
ninŋuq	! cottonwood tree (K)
nipaiľuktaq	! short-earred owl (Asio flammeus) (lit. flies soundlessly) (K)
nipaiqsuq	! becomes quiet
nipaiḷuktaq	! short-earred owl (Asio flammeus) (lit. flies soundlessly) (n)
nipi	! voice, sound
nipitchaq	! octopus
nipliqsuq	! says, sounds, voices (K)
nippivik	! November (lit. sunset time) (N)
nipuŋaiqsuq	! alert
niqaaq	! plant stem
niqaat	! lichen
niqaat	! swamp grass
niqi	! meat, food
niqi	! meat
niqipiaq	! real food (meat)
niqipiaq	! meat (vs. food)
niqsaaqtuŋiq	! rock ptarmigan (Lagopus mutus)
niu	! leg
niuġaun	! drill, brace
niugaaq	! broken leg (K, N)
niuk	! both legs
niulġiq	! dragon fly
niuqqaq	! snack time, refreshment (N)
niutaq	! stern or bow
niutaq	! (5) stern or bow (5)
niutuiyiq	! lynx (Lynx canadensis) (N)
niutuuyiq	! lynx (Lynx canadensis) (q)
niviaqsiaġruk	! girl (before puberty)
niviaqsialugruaq	! little girl
niviaqsiaq	! young lady (marriageable)
niviŋaqutaq	! red current (Ribes triste) (K)
nivliqsuq	! says, sounds, voices (N)
nuġġaaġruk	! calf during first winter (N)
nuġġaatchiaq	! calf during 2nd winter (prime skin)
nuġġaiḷaq	! cow without fawn
nuġġaiyaaq	! newborn fawn
nuġġalik	! cow with fawn
nuġġalik	! miluktitkaa cow nurses fawn
nuġġaq	! fawn, colt (less than 1 year)
nuġġaq	! miluktuq fawn sucks
nuġġayauq	! newborn fawn
nuŋaktuaġruk	! white-crowned sparrow (Zenotrichia leucophrys)
nuŋŋaq	! nose bridge (N)
nuŋŋich	! floating ribs (K)
nukaaluga	! my younger brother (N)
nukaġiitka	! my family
nukaqłiġa	! my youngest child
nukataġaaġruk	! large bull (just matured) (K)
nukataġaaluk	! bull nearly full grown (N, q)
nukataġagruaq	! large bull (just matured) (N)
nukataġaq	! three year old bull (K)
nukataġauraq	! young bull (2-3 years) (N)
nukatchiaġa	! my younger sibling (K)
nukatchiaġa	! my younger sister (N)
nukatpiaġruk	! boy
nukatpialugruaq	! small boy
nukatpiaq	! young man (marriageable)
nukik	! tendon, muscle
nukik	! tendon, ligament, cartilage
nukiľhaaq	! cloth (K)
nukisuġaq	! horned owl (Bubo virginianus)
nukuutchiqiq	! belted kingfisher (Megaceryle alcyon)
nuliaġa,	! abnaba my wife
nuliaġniq	! stinking caribou bull (after breeding)
nuliaġvik	! October (lit. breeding time for caribou) (N)
nuliaksraun	! bride (N)
nuliiqsuaq	! widower (K)
nullaġvik	! hotel, inn (K)
nullautaq	! supper (N)
nullautchiq	! supper (K)
nulliġuvik	! October (lit. breeding time for caribou) (kiv)
nuluq	! snowshoe webbing
nuna	! land, earth
nunaaqqiq	! city, town, village, nation
nunaŋiak	! alder tree, rust colored dye from alder bark
nunagluk	! wilderness (bad land)
nunauruat	! country, nation
nunavak	! walrus on ice
nunavik	! undulating tundra
nunuqsiġiiḷaq	! buffle-head duck (Bucephala albeola)
nuqaġun	! (9) lashings for lower stands (9)
nutaaq	! newness, freshness
nutaġaq	! fresh snow, powder snow
nutaqqat	! young people
nutchat	! head hair
nuttagayuk	! grasshopper (N)
Nuurviŋmiu	! Noorvik dweller
Nuurvik	! move place, Noorvik
nuutuuyiq	! lynx (Lynx canadensis) (K)
nuvaq	! male fawn (N)
nuviivak	! fly, blow fly
nuviivaum	! qupilbuksrafa egg
nuvirat	! fish strung on a willow stick
nuviya	! cloud
nuvuk	! point, promontory
nuvuliksrat	! floating ribs (N)
nuvuya	! cloud (N)
paa	! entry, door, opening (river mouth)
paaŋŋa	! from up there (N)
paaŋuutik	! qayaq paddle (K)
paakŋa	! from up there (K)
paani	! located up there
paaqsaaġutiruk	! they (2) pass each other
paatitaaq	! wild chives (Allium schoenoprasum), onion (K)
paġlan	! greeting, welcome
paŋmapak	! now (N)
paŋniq	! caribou bull (mature) (K)
pagga	! up ther (above and behind speaker), away from shore, landwards, mountainwards
pagniaġruitchiaq	! very old bull (with worn teeth) (N)
pagniq	! caribou bull (mature) (N)
paikinaq	! pig (lit. queer deer) (K)
paipiiraq	! baby (N)
paisugruk	! red-breasted merganser (Mergus serrator)
pałuqtaq	! beaver boot fur trim (K)
pałuqtaq	! beaver (Castor canadensis)
pakiksuq	! squeezes trigger
pakiksuq	! paws (N)
pakimna	! heaven (lit. up there) (K, q, n)
pakimna	! that one up there, (invisible)
pakma	! now (K)
pakma	! heaven (lit. up there)
palaġniqsuq	! worthless
palapkaaq	! tent (K)
palauvak	! flour
palliksraq	! cotton (used for tinder) (from cotton grass, pussy willow buds, cotton wood buds)
palliksrat	! pussy willow
paluqtaq	! beaver boot fur trim (N)
pamaŋna	! wind from land (p)
pamiałuk	! tailbone (sacrum) (K)
pamiuġayuk	! tailbone (sacrum) (N)
pamiuq	! tail
pamiuqtuuq	! otter (Lutra canadensis) (K)
pamiuqtuuraq	! mosquito larva
pamma	! back there, behind, landwards, mountainwards (absent, beyond reach, invisible)
pamna	! that one behind, back there (invisible)
pana	! spear, two edged cutting tool
pana	! quill of porcupine (two-edged knife, sword, spear)
panapkaaq	! tent (q,s)
paniga	! my daughter
paniqsiqsiivik	! March (lit. skin bleaching)
paniqtaq	! dried meat or fish
papa	! pepper
papik	! tail
papiktuuq	! marsh hawk (lit. long parka tail) (Circus cyaneus)
paqinġitchuq	! did not find
paqitkaa	! found it
patiq	! marrow
pauŋa	! towards up there
pauŋaak	! rubber boots
paugaq	! tent peg, stake
paułhiñ	! shovel (n)
pauktaun	! (7) anchor (7)
paula	! soot
paulġiñ	! shovel
pauna	! by way of up there
paunġaq	! crowberry, blackberry (Empetrum nigrum)
pavaŋŋa	! from back there (N)
pavakŋa	! from back there (K)
pavani	! located back there
pavuŋa	! towards back there
pavva	! back there (behind speaker), away from shore, landwards, mountainwards
pi	! - base substitute to which any post base or suffix may be added
piaġniq	! hind lower leg (N)
piaŋniq	! hind lower leg (K)
piayaaq	! offspring
piġiaġaq	! (7) rounded portions (7)
pichqun	! law (what is wanted to be done), commandment (K)
piñasrukipiaq	! sixty (K)
piñasrukipiaq	! qulit seventy (K)
piñasrut	! three (K)
piñña	! up there (above, visible)
piñŋuqtaq	! folding or pocket knife (N)
piñiq	! insole
piŋasukipiaq	! sixty (N)
piŋasukipiaq	! qulit seventy (N)
piŋasut	! three (N)
piŋuq	! individual round hill (swelling) (N)
piŋuq	! swelling
piŋuqsraq	! individual round hill (swelling) (K)
piga	! mine
pigaatin	! he (wants) you
pigigiga	! it is mine
pigliġailik	! grasshopper (K)
pigliġayuk	! grasshopper (n)
piiġaq	! gray-cheeked thrush (Hylocichla minima)
piiŋiḷaaq	! ghost, haunting spirit of a departed one
piiŋiḷaq	! ghost, haunting spirit of a departed one
piitchuq	! nothing, no one, empty
piksraġniqsuq	! chooses (K)
piksrun	! shovel
pilik	! ice crystals in air (N)
pipsaamik	! more (if you please)
piqaluyak	! glacial ice (blue appearance)
piqasiqsuq	! accompanies
piqatigigiŋma	! I am your companion (lit. you have me for a companion)
piqatigiiksut	! are together
piqatigiiktuk	! are together (2)
piqpaksriłiq	! love
piqpaktaq	! love (K)
piquk	! 3 or 4 longest vertabrae near neck
piqusuk	! vertebra (N)
piqusuk	! longest bone of shoulder hump
piraksriqsuq	! admonishes
pisaġaluaġnak	! excuse me! (N)
pisanġitchikpiñ``	! excuse me! (K)
pisiksi	! bow (N)
pisiqpisiqpiisrhaq	! tree sparrow (Spizella arborea)
pisuġuġiqsuq	! hunger is satisfied
pisukkaaq	! fox (N)
pitcha	! up there (above, visible)
pitchaiḷikkich	! stop (doing) those things!
pitchiġiyaun	! key
pitŋuqtaq	! folding or pocket knife (K)
pitqiksuq	! happens a second time, does it once more
pitqun	! law (what is wanted to be done), commandment
pitquraq	! law (what is wanted to be done), commandment (N)
pitquraq	! law, command
pituich	! chain
piuraaq	! toy (N)
pivik	! place, time
piviksraq	! place for, occasion for, time for
piviuttaqqun	! love (N)
pivsaamik	! more (if you please!)
piḷiun	! blessing (passing of power from a shaman to his disciple)
piḷuun	! error, crime, sin (N)
piḷuun	! sin (N)
piḷuusiqiri	! sinner, wrong doer (N)
piyaqquġvik	! hell (place of accident)
Piyumiñaitchuŋa.	! I cannot do it.
Piyumiñaqtuŋa.	! I can do it.
pualuk	! trail mittens
puggutaq	! dish pan (any bowl-like container)
puggutauraq	! bowl
pukak	! sugar snow (near ground)
puksraaq	! sleeping bag
puktaaq	! iceberg
punnilivik	! oven, (lit. bread-making-place) (N)
punniq	! yeast bread (N)
puptaaq	! floating moss (not walkable)
puptaġun	! float (buoy) (K)
puptaqun	! buoy
puptaqutaq	! buoy
puptaun	! net float
puttun	! piercing tool
putu	! hole, piercing
putuguq	! big toe
putuguqsiiġayuk	! stag beetle
putuguqsiuyuk	! shrimp, (lit. going for big toe)
putukiiłuk	! Alaska longspur (Calcarius lapponicus)
putukiiłukpak	! smith's longspur (Calcarius pictus)
putukiiľuk	! American water pipit (Anthus spinoletta)
putyuun	! crab (lit. pinching tool) (K)
puuksraq	! envelope, wrapper
puuq	! seal skin poke
puvaich	! lungs
puviaq	! bay
puviaq	! crop
puviaqtuuq	! pectoral sandpiper (Erolia melanotus) (lit. inflating the chest)
puviaqtuuyaaq	! baird's sandpiper (Erolia bairdii)
puvlakaq	! yeast bread (K)
puvliġniq	! resin drop (of spruce trees, used as chewing gum)
puya	! dirt, grime
puyuġvik	! chimney
puyuq	! smoke from a chimney, smudge
qaaŋa	! its topside, dorsal area
qaaŋa	! its top side, dorsal area of a fish
qaaŋani	! on top
qaaŋiqsuq	! passes by
qaaŋiułaaŋavaitchuq	! veers away, goes to excess (N)
qaaglaan	! when? (past tense interrogative) (K)
qaaktuun	! seining net
qaalġiq	! whitefish (smaller sharp nosed) (K)
qaaqtaq	! breaker on shore
qaatchiaq	! mattress, (upper of two caribou skins, fur facing up) (K)
qaayuq	! dirt (K)
qaġlik	! Eskimo waterproof boot (N)
qaġlik	! fur breeches (fur in)
qaġrupiat	! bow and arrow
qaġruqaġvik	! ammunition case (K)
qaġruuraqtuun	! shotgun (N)
qaŋa	! when? (past tense interrogative) (N)
qaŋaa	! no! used more sparingly than English "no" (K)
qaŋaa	! no! (emphatic), or (K)
qaŋma	! outside (N)
qaiġaiḷaq	! siku rough ice causing difficult travel
qaiġulik	! ringed seal (Phoca hispida) (N)
qaiġutlik	! ringed seal (Phoca hispida) (K, q)
qaiŋaitchuq	! did not come (never having before come)
qaiŋŋiq	! green-winged teal (Anas carolinensis)
qaipkaġmagitin	! tell her to come (cause her to come)
qałiq	! rust
qakirvik	! shelf
qakma	! outside (K)
qaksrauq	! red-throated loon (Gavia stellata)
qakugu	! when? (future interrogative)
qakugu	! anytime
qakugun	! when? (future interrogative)
qalasiq	! umbilicus (naval)
qaliq	! shirt
qallugauraqaġvik	! food shelf, dish shelf
qallun	! cup, dipper
qallun	! bailer, cup
qallutaun	! ladel, large spoon (K)
qalu	! dip net
qalugruaq	! salmon, chum, humpback salmon (K)
qaluk	! fish (K)
qalukisaq	! butterfly (K)
qalukpik	! trout, lake trout, arctic char (K)
qaluksiuġayuk	! osprey (Pandion haliaetus) (lit. goes for fish) (K)
qalupiat	! whitefish (Coregonidae) (K)
qalusraaq	! whitefish (smallest) (K)
qamaŋŋa	! from inside (N)
qamakŋa	! from inside (K)
qamani	! on the inside, at the inside
qamani	! located inside
qamma	! inside (further from entrance than speaker), (upriver)
qamma	! upriver, inside (further from entrance than speaker)
qamna	! that one inside, that one upriver
qamuŋa	! toward inside
qamutit	! sled for transporting umiaq over ice (N)
qanik	! frame for winter skin tent
qaniq	! oral cavity, mouth
qaniq	! mouth
qanisaq	! entrance hall, shed (K)
qanitchat	! entrance hall, shed (N)
qannik	! snowflake
qanuġviitchuq	! it cannot be helped, too bad (that he died, is mortally itt, etc.)
qanuq	! how, what, for, because (N)
qanusiq	! what kind? (N)
qanusriq	! what kind? (K)
qanutun	! how long, how much?
qanutun-aglaan	! how far?
qapsiñik	! how many?
qapvaitchiaq	! marten (Martes americana) (K)
qapvik	! wolverine (Gulo luscus) (K)
qaqisaq	! brain
qaqłiik	! fur breeches (fur in)
qaqłu	! lip
qaqłuk	! lips
qaqłukpalik	! greater scaup duck (Aythya marila)
qaqłuktuuq	! lesser scaup duck (Aythya affinis)
qaqqiaq	! pilot bread
qaqquayaaq	! cookie (K)
qaqqulaaq	! pilot bread (N)
qaqqulaaraq	! cookie (N)
qaqquq	! pilot bread (K)
qargi	! community house
qarraq	! mattress, (lower of two caribou skins, fur facing down) ground sheet (K) (N)
qarviaq	! sole patch
qasigiaq	! spotted seal, harbor seal (Phoca richardii)
qasraun	! bell (an instrument to make repeated noise by hitting) (K)
qasraun	! bell (lit. instrument for repeated noise by striking) (K)
qasruaġaa	! (wind) died down (K)
qataġa	! my illegitimate child
qataŋutiga	! my illegitimate sibling
qatchiruaq	! slope (wall)
qatiqsuġniq	! light snow, deep for walking (N, K)
qatiqtaaq	! whiteness
qatraq	! echo (K)
qattaġniq	! valley, pass (a)
qattaq	! water container without cover
qauġrimmaaġiitchuq	! cannot recognize one
qauġrimmaiqsuq	! fainted (K)
qaugak	! duck
qaumaniq	! beam of light
qaunagiraksraġigaa	! must be caring for it
qaunakłaŋitchuq	! careless
qaunaq	! fat
qauq	! forehead
qaurikłiqsuq	! catches on (N)
qausriḷuk	! whitefish (big round nosed) (K)
qavaasuk	! spectacled eider (Somateria fischeri)
qavlunaaq	! eyebrow ridge
qavlunaq	! brow of hill (also of human)
qavlut	! eyebrow
qavsiñik	! how many?
qavva	! over there, upriver (visible)
qavvik	! wolverine (Gulo luscus) (N)
qayaq	! decked-in skin canoe
qayuŋnilik	! crystal (rock crystal, bead)
qayuqłaq	! rippled surface of snow
qayuutaayuuq	! slate-colored junco (Junco hyemalis)
qayuutaq	! ladel, large spoon (N)
qayuutauraq	! lower tip of sternum
qayuuttaaq	! pine grosbeak (Pinicola enucleator)
qayyiuġun	! northern phalarope (Lobipes lobatus) (lit. like a person in a qayaq)
qianarutuuq	! golden-crowned sparrow (Zenotrichia atricapilla) (lit. is to be mourned)
qianġaq	! blue fox (K)
qiaranatuuq	! golden-crowned sparrow (Zenotrichia atricapilla) (lit. is to be mourned)
qiġaich	! willow stumps
qiġñiqtaaq	! blackness
qiġñiqtaq	! black or silver fox
qiñiġaaq	! picture (N)
qiñuiñaq	! peace (K)
qiŋaġluk	! porcupine (Erithizon epixanthum)
qiŋalik	! king eider duck (Somateria spectabilis)
qiŋaq	! nose (house ventilator)
qiŋaq	! ventilator (nose)
qiŋŋak	! nostrils (K)
qikaaġvik	! stands at the back
qikiqtaġruk	! big island (K, q)
qikiqtaq	! island
qikiqtasugruk	! big island (N)
qiku	! clay
qilamik	! quickly, immediately
qilġun	! (15) upper lashings (15)
qilġuq	! scar
qimaktuaq	! fugitive (K)
qimaugruk	! snowdrift blocking a trail or in lee of a building
qimialuk	! foothill
qimiġaaq	! ridge
qimmiaġruk	! puppy (N)
qimmich	! dogs, team
qimmiq	! dog (N)
qimmiurat	! tundra cotton (lit. little dogs) (N)
qimuġruk	! stepped rise
qimuġviitaq	! (14) bridle (sled to dog) (14)
qimuġvik	! (14) bridle (sled to dog) (14)
qinu	! broken chunks of slush ice
qipaluaq	! steep undercut river bank
qipiġniuġun	! desire
qipiġniuġutigituiññaqsigik	! keep on desiring them
qipmich	! dogs, team
qipmiq	! dog (K)
qipmiuraq	! puppy (K)
qipmiḷiqun	! dog whip (K)
qiqitiq	! frostbite (N)
qiqsruqaq	! glazed snow in thaw time
qiquyaliqsuq	! northern lights are shining
qirġiaqtaaq	! grayness
qiruiqsuq	! ran out of wood
qiruk	! dry fire wood
qiruk	! dry, dead wood
qisaġruaq	! first stomach
qisaġuaq	! first stomach (K)
qisiqsiun	! branch (N,n)
qisuk	! dark cloud over open water (109)
qitauraq	! dress (N)
qitiġaġun	! (16) tug (16)
qitiġaġun	! (5) main tug (5)
qitiġusianikpata	! afternoon (lit. when they passed the middle)
qitiq	! waist (middle)
qitiqłiq	! middle finger (K, N, q)
qitiqqaqpalliġman	! when it was about noon
qitiqquutaq	! noon meal (lunch) (N, q)
qitunġaaġaitka	! my family
qitunġauraq	! baby
qiviuq	! down (of water fowl), wool (of muskox)
qiviut	! down, musk oxen wool
qiḷa	! shaman's power or familiar spirit, conjuring spirit
qiḷaŋaq	! common puffin, tufted puffin (Lunda cirrhata)
qiḷaŋmiutauraq	! collared lemming (Dicrostonyx rubricatus)
qiḷagaq	! palate, roof of mouth
qiḷak	! net lashing
qiḷak	! ceiling
qiḷak	! sky, heaven, roof
qiḷak	! heaven
qiḷallautaq	! Holy Spirit (K)
qiḷam	! qaafa roof (lit. ceiling's top)
qiḷamitautit	! bola
qiḷaun	! divining rod (used by diviners, e.g. to foretell death or life of a sick person)
qiḷaun	! drum
qiḷaun	! divining rod
qiḷausiraqti	! drummer
qiḷġich	! basket sled
qiḷġich	! tatqiat March (lit. white hawks coming) (K)
qiḷġiq	! rough-legged hawk (Buteo lagopus)
quaġaq	! sourdock, wild spinach (Rumex arcticus)
quaq	! raw frozen meat or fish
quayaqitchuq	! slips
quġluqtaq	! waterfall
quġvik	! chamber pot
quŋialik	! (2) seat in front of pilot (2)
quŋisiġun	! dog collar, neck band
quŋisiq	! neck
quŋisiq	! neck (K)
quŋuliq	! wild rhubarb, sour grass, mountain sorrel (Oxyria digyna)
quŋusiñiq	! neck
quŋusiq	! neck
qugluġiaq	! pupa
qugluŋniq	! hem
qugruk	! whistling swan (Olor columbianus)
quiqsuq	! coughs (N)
qułhaaq	! arctic fox (Alopex lagopus) (K)
quli	! boot fancy trim
quliaqtuaq	! true story
quliġik	! back (N)
quliġuaq	! set of shelves (K,q)
quliŋŋuutaiḷaq	! nine (N)
quliŋuġutaiḷaq	! nine (K)
quliik	! back (K)
quliksak	! caribou or reindeer skin pants (fur out) (N)
qulit	! ten
qulit	! atausiq eleven (N)
qulit	! atausriq eleven (K)
qulit	! malbuk twelve
qulit	! pieasrut thirteen (K)
qulit	! pifasut thirteen (N)
qullimġaat	! upper teeth
qulliq	! uppermost
qulliq	! lamp (N)
qulvich	! tears
qumiksuq	! folds arms inside of parka
qunġuq	! brightness on horizon indicating presence of ice on ocean
qunŋiq	! reindeer (Rangifer tarandus)
quniqłuk	! indistinct horizon, hazy
qunmun	! asriaq bog cranberry (Vaccinium oxycoccus) (K)
qupałuk	! Alaska longspur (Calcarius lapponicus)
qupak	! fancy trim
qupilġuksraq	! egg
qupilġuq	! larva, worm
qupiḷġuġruaq	! edible sea worm
quppaq	! crack, split
quppiġaaq	! coat (lit. split) (K)
quppiq	! outside garment, coat
quppiqutaq	! fireweed (edible young shoots) (Epilobium angustifolium)
quptik	! whitefish (small sharp nosed) (K)
quqhiqsuq	! coughs (K)
quqsuqtaaq	! egg yolk (N)
quqsuqtaaq	! yellowness (N)
quqtaq	! urine (N)
quqtuġaq	! thigh
qurraquraq	! semipalmated plover (Charadrius emipalmatus), killdeer (Charadrius vociferus)
qusrhaaq	! arctic fox (Alopex lagopus)
qusrimmak	! wild rhubarb, (Polygonum Alaskanum) (K)
qusruŋŋaq	! outer fur parka (K)
qusuŋŋaq	! outer fur parka (N)
qutuk	! collarbone (clavicle)
quviasuqasiqsiŋa	! rejoice with me!
quvluun	! rip saw (N)
quyanaq	! thank you!
quyanaqtigiva	! how much he is to be thanked
saa	! body front
saatkaaq	! shotgun (K)
saġlupkutaq	! appendix (N)
saġvaġiksuq	! flows swiftly
saġvaq	! tifmiaq harlequin duck (Histrionicus histrionicus)
saġviqsuq	! comes into view, is revealed (K)
sagviqsuq	! appears, becomes plain, obvious
saiġuuq	! (6) central stringer (6)
saigut	! cache on the ground
saiyu	! tea
saiyutuġvik	! tea pot (K)
sakiagich	! breast bone (sternum)
sakiak	! breast bone
sakma	! in front of (closer to entrance than speaker) (K)
salapqiqsuq	! comes into view, is revealed (N)
salapqiqsuq	! reveals, appears (N)
salikkuun	! broom (q)
sallisik	! scissors
salummaun	! cleanness, holiness (N)
samaŋŋa	! from down there (N)
samakŋa	! from down there
samani	! located down there
samma	! let's see!
samma	! down there, downriver, oceanward, in front of
samna	! the one down there, the one there in front
samuŋa	! towards down there
samuuna	! through or along down there
sanalġun	! tool (K)
sanalġun	! tool (N)
sanŋiyautit	! broom (K)
saniġaagun	! (12) crossed ropes (12)
saniġaq	! side
saniqqak	! both sides
sanluġuvik	! tool kit (N)
sanniġutaq	! cross (K)
sanniġutaq	! cross beam
sanniqsaq	! log cabin (q)
saqalataayiq	! tree squirrel, red squirrel (Sciurur hudsonicus) (K)
saqłataiyaq	! tree squirrel, red squirrel (Sciurur hudsonicus) (N)
saqsakiq	! common redpoll (Acanthis flammea) hoary redpoll (Acanthis hornemanni)
sarri	! ice pack
sassaq	! clock, watch, hour (Russian loan) (K)
sassaq	! hour, watch, clock (Russian loan word) (K, q)
satkut	! hunting equipment, weapons
satkuun	! ammunition case (N)
satqagiiḷaq	! buff-breasted sandpiper (Tryngites subsuficollis) (lit. rough breasted)
satqak	! chest
satqatiktaaq	! egg white (N)
saumik	! left side
sauniq	! bone
sautaaq	! anchor for trap or snare
savaŋniqsutin	! you are working (lit. in state of working)
savagviksraq	! time for work
savaiññaqpata	! Sunday, Sabbath (N)
savaiññiq	! Sabbath (N)
savaktaksraġigiga	! I have to work on it
savakti	! worker
savaktillautaq	! a good worker
savaktitluŋa	! while I work
saviġuq	! ice crystals in air (K)
saviiġaviiq	! gray-cheeked thrush (Hylocichla minima)
savik	! knife
savik	! hunting knife
savik	! knife
saviksraq	! iron (K)
saviľhaaq	! iron (N)
sayaiqsuq	! fainted
siġḷuaq	! underground cache, cold storage
siñi	! fur ruff of parka (K)
siñiġñiq	! ankle joint (N)
siñigvik	! bed (lit. sleeping place)
siŋŋiq	! any large arm or leg muscle
siŋiġñiq	! ankle joint (K)
siŋiq	! boot strap (N)
siŋiq	! boot strap (K)
siŋiqsuq	! ties mukluk strap
siŋutlulluuq	! varied thrush (Ixoreus naevius)
sigguk	! one mandible (N)
sigguuk	! beak, bill (N)
sii	! sheefish (Stenodus leucichthys nelma)
siilik	! northern pike (Esox lucius) (q)
siiyukpaligauraq	! dunlin, red-backed sandpiper (Erolia alpina pacifica)
siiyukpalik	! long-billed dowitcher (Limnodromus scolopaceus)
sikľaq	! pickaxe (N)
siksi	! bow (K)
siksrik	! ground squirrel (Citellus parryi)
siksrikpak	! hoary marmot (Marmota caligata)
siku	! ice
siku	! (2) runner rod, runner base (2)
sikuiġvik	! ice break-up time
sikuiġvik	! May (lit. ice break-up time) (K)
sikuiñŋaan	! before it froze
sikukłaq	! hailstone
sikuliaq	! ice thick enough to walk on
sikuliuraq	! new formed ice
sikuq	! bit
sikuq	! (2) runner rod, runner base (2) (K)
sikuvik	! October (lit. ice time) (K)
simik	! diaphragm (K)
simmausiqsuq	! exchanges
sipik	! caudal fin, fish tail
sippak	! something left over, surplus
sippun	! gun, rifle (K)
sipyaaq	! hip joint (K)
siqiñaaġiksuq	! sun shines
siqiñaaġiksuq	! sun is shining (N, K)
siqiñaasrugruk	! January (lit. new sunshine) (K)
siqiñaasugruk	! February (lit. longer sunshine) (N)
siqiñaatchiaq	! December (lit. no sunshine) (K)
siqiñaatchiaq	! January (lit.new sunshine) (N)
siqiñġiḷaq	! December (lit. no sunshine) (N)
siqiñġuraq	! timepiece, clock (N)
siqiñiq	! sun
siqpiich	! eyelashes
siqupsiqqat	! Pleiades constellation
sisamakipiaq	! eighty
sisamakipiaq	! qulit ninety
sisamalik	! 8' x 10' wall tent (lit. with four, meaning four panels long) (K,q)
sisamat	! four
sisuaq	! beluga whale (Delphinapterus leucas) (K)
sisuuq	! snowslide, avalanche
sitquaq	! kneecap (patella)
sitquaq	! (5) rear flipper of seal, walrus (5)
sitquq	! kneecap (patella) (N)
sitḷiq	! hard crusty snow (K)
siuġruk	! pressure appliance, stove (N, K)
siulik	! northern pike (Esox lucius) (N)
siun	! ear
siunŋuraq	! ear cavity
siunŋuraq	! ear cavity (N)
siutiġun	! earpendant
siutik	! ears (2)
siutquraq	! ear cavity (K)
siutuquyuk	! mollusk, shell
siutuvak	! whimbrel (Numenius phaepus hudsonicus)
sivu	! front (bow of boat)
sivu	! (7) bow (7)
sivuani	! before (lit. at its front)
sivuġaġluk	! foreleg (K)
sivuġat	! cutting teeth
sivuġun	! (10) front bow (10)
sivukkiksuq	! sets a straight course
sivulliq	! foreleg (lower section)
sivulliq	! first one, foremost one
sivuniksriqiri	! prophet
sivunniqsuq	! decides, plans
sivunniun	! plan, purpose, decision
sivviaq	! hip joint (N)
siḷa	! weather, outside, atmosphere, air
siḷaavyaq	! hotcake (pancake)
siḷagiksaaq	! blueness (K)
siḷaluksiiyauraq	! myrtle warbler (Dentroica coronata) (lit. rain again)
siḷam	! ieua spirit governor of the atmosphere (lit. person of the air or sky)
siḷu	! carcass of a sea mammal drifted ashore
siḷu	! jellyfish (K)
siḷḷiñ	! knife sharpener (emery stone)
siḷḷiq	! hard crusty snow (N)
siyyuk	! one mandible (K)
siyyuuk	! beak, bill (K)
siyyuum	! kipifaruq white-winged cross-bill (Loxia leucoptera)
su	! - question marker (N)
sua	! what?
suġaliq	! thing, wealth, treasure (N)
suġaq	! blueberry (Vaccinium uliginosum) (sh)
suġliq	! horned grebe (Podiceps auritus)
suġlitchauraq	! red-necked grebe (Podiceps grisegena)
suġlu	! nasal cavity
suġluq	! nasal passage, nose cavity
suġruich	! a group of fighters, war party
suŋaaqtaaq	! greenness
suŋaq	! gall bladder
suŋaqpaluktuŋiq	! arctic warbler (Phylloscopus borealis) yellow warbler (Dentroica petechia)
suŋaqtaaq	! green
suŋauraaqtaaq	! blueness (N)
sukkitchuq	! gets a thorn or tack into his flesh
sukpaluk	! sound
sukun	! how, by which way?
suli	! and (used in an additive sense, contrasts with aasii/aasrii)
suliqaa	! anything
suliqutigiŋaiqsuq	! forgives, ignores
suliqutigiŋaiqsuq	! forgives, (ignores, overlooks) (N)
suliva	! what is he making?
suluk	! wing feather
suluktaatchialik	! bohemian waxwing (Bombicylla garrulus) (lit. with pretty wing feathers)
suluppaugaq	! grayling (Thymalus signifer)
suluun	! dorsal fin
sumi	! where?
sumiñ	! from whence?
summan	! why?
sumuliqaa	! anywhere
sumun	! to where?
suna	! what?
suppugaaluk	! old rifle
suppun	! gun, rifle (N)
suppuqtaġvia	! (4) blowhole (4)
suqqaq	! (3) baleen (3)
susaqpich	! where are you trying to go?
suunaaġa	! my friend (male to male)
suuramikuunii	! in no wise
suuraq	! thing, wealth, treasure (K)
suvaata	! why?
suvaich	! fish eggs, spawn
suvaluk	! especially
suvich	! what do you want?
suvluġvik	! May (lit. rivers flow) (N)
suḷiqivich	! what are you doing?
ta-	! adds emphasis or extends direction
taaŋŋaqti	! drunkard
taakti	! medical doctor
taamna	! that one (person or thing)
taapkua	! those
taapkunaŋŋa	! from those (N)
taapkunakŋa	! from those (K)
taapkunani	! at, in, on those
taapkunatun	! like those
taapkuniŋa	! (with/about) those
taapkunuŋa	! to, for those
taapkunuuna	! through, by those
taaqsipaiyaaq	! half-Negro
taaqsipak	! Negro
taataga	! my father (K)
taataruaġa	! my grandfather, great uncle (K)
taatchiŋiq	! common or black-billed loon (Gavia immer)
taatchiŋiuraq	! slate-colored junco (Junco hyemalis)
taavruma	! that one's
taavrumaŋŋa	! from that (N)
taavrumakŋa	! from that (K)
taavrumani	! at, in, on that
taavrumatun	! like that
taavrumiŋa	! (with/about) that
taavrumuŋa	! to, for that
taavrumuuna	! through, by that
taġġaqtuun	! mirror, reflector
taġium	! sieaa beach (lit. place between ocean and cliff) (N)
taġium	! sieaun beach (lit. place between ocean and cliff) (K)
taġiuq	! salt, ocean
taġiuq	! ocean, salt
taġiuq	! salt, ocean
taŋŋaq	! intoxicating beverage, alcohol
tagluk	! snowshoes
taimaŋŋa	! from yonder, from time immemorial (N)
taimakŋa	! from yonder, from time immemorial forever (K)
taimani	! located there (over yonder), at that time
taimani	! then, at that remote time (past or future)
taimña	! that one ( remote in place or time)
taimma	! there, then, when (very distant in place or time, beyond taamma)
taimmaiñaq	! suddenly
taimuŋa	! forever
tainna	! like (N)
tainnaunnii	! although not very good, it is okay
taipchua	! those (remote in place or time) (K)
taipkua	! those (remote in place or time) (N)
taitna	! like (K)
takpaak	! nostrils (N)
takparuak	! nostrils (K)
takpiiḷaaġruk	! boreal owl (Aegolius funereus)
takpiksuq	! sees keenly
taksruk	! oval-shaped lake
taktuk	! kidneys
taliġuq	! (6) foreflipper (6)
talim	! ivalua arm sinew
taliq	! arm
taliqpik	! right side
talliaq	! broken arm
tallimakipiaq	! one hundred
tallimalik	! 10' x 12' wall tent (lit. with five, meaning five panels long) (K,q)
tallimat	! five
tallimat	! malbuk seven
tallimat	! pieasrut eight (K)
tallimat	! pifasut eight (N)
talu	! door (K)
taluksraq	! door material, bear skin door (K)
talukuyaaq	! curtain
tamaani	! here indeed
tammaġaa	! lost it
tammaġvik	! hell (place of suffering)
taniayaaq	! half-white
tanik	! white person (N)
tapsi	! woman's belt (K)
taqaq	! vein, artery, blood vessel (K)
taqaqpak	! vein, artery, blood vessel (K)
taqilakisaaq	! northern buttercup (Ranunculus affenis)
taqtu	! kidney
taquaq	! trail snack
tarra	! that's right! Then (conj.) that's all (at end of story) (K)
tarvauvva	! at once, immediately
tasamma	! down there, downriver, oceanward, in front of (N)
tasiq	! lagoon, lake (N)
tasramakŋa	! from down there (K)
tasramani	! located down there
tasramma	! down there, downriver, oceanward, in front of (K)
tasramuŋa	! towards down there
tat-	! adds emphasis or extends direction
tatirgaq	! lesser sandhill crane, little brown crane (Grus canadensis)
tatqiġiksuq	! moon shines
tatqiq	! month (moon)
tatqiq	! moon
tatqiq	! nuiruq new moon
taugga	! there (doorwards, visible)
tauqsiqsuq	! buy
tautukkisigaat	! they will see it
tautukpaallukkiga	! first time I see it
tavlu	! chin
tavluġun	! chin tattoo
tavra	! that's right! Then (conj.) that's all (at end of story) (N, q)
tavrauvvaa	! at once, immediately (N, q)
tavsi	! man's belt (K)
tayaġniq	! wrist
tiġiaq	! weasel (Mustela erminea) (K, q)
tiġiaqpak	! mink (Mustela vison) (K, q)
tiġiganniaq	! arctic fox (Alopex lagopus) (N)
tiġiksraq	! man's belt (N)
tiŋaaglut	! things washed ashore
tiŋauraq	! dried black moss (used for tinder)
tiŋŋivik	! September (lit. birds fly, migrate)
tiŋŋun	! airplane (N)
tiŋilġaqsiqsuq	! sails (K)
tiŋilġautaq	! sail
tiŋisaqpich	! are you trying to fly? (away)
tiŋmiaġruum	! kirgavia pigeon hawk, (lit. duck hawk) (Falco columbarius)
tiŋmiam	! qipmia lesser yellowlegs (Totanus flavipes) (lit. goose's dog)
tiŋmiaqpak	! eagle, golden eagle (Aquila chrysaetos), bald eagle (Haliaetus leucocephalus)
tiŋmiaqpauraq	! European wheatear (Oenanthe oenanthe) (lit. little eagle)
tiŋmirrat	! tatqiat April (lit. geese are coming) (K, N)
tiŋmisuun	! airplane (K)
tiŋuk	! liver
tiggaŋniq	! strong smelling bull seal
tiguaq	! adopted child
tigumivik	! handle
tigutaaġvik	! prison, jail (N)
tii	! tea (N)
tiiliuġun	! tea pot (N)
tikalaak	! three finger mittens (N)
tikiġaq	! forest
tikilik	! three finger mitten (K)
tikiq	! thimble
tikiq	! pointing finger
tikitchuq	! arrives
tilaaqiaq	! Hudson's bay tea (Ledum decumbens)
tilaġġisit	! broom (N)
Tiliŋmun	! nibitqugai. He wants Tilak to eat them.
tilirauruaq	! an apostle
tilliñ	! commandment, order
timi	! body
timi	! boot upper (lit. body)
tiniika	! moose (Alces alces) (K)
tiniikaq	! moose (Alces alces) (q, n)
tinnik	! bearberry (Arctostaphylos uva-ursi)
tipi	! odor
tipigiqsaun	! perfume (lit. a means or cause of good odor), incense (K)
tiqituġaurat	! herd of cows and calves
tiqitut	! herd of cows and calves
tiritchiq	! monsterous reptile, dragon (with four short legs - originally six - with alligator-like tail, rocky scaled skin, long neck and small head)
tirraq	! sandbar, mile (measure) (K)
titiq	! mark, dot, line
tittaaliq	! mudshark, ling-cod, burbot (Lota lota)
tittaq	! mark, dot, line
tivliyyaun	! napkin
tivraġiksaun	! perfume (lit. a means or cause of good odor), incense (N, q)
tivvuaq	! saliva
tuġnaaq	! joiner (N)
tuggaun	! poking stick
tuggayuuq	! wasp, hornet, yellow jacket
tugrun	! (11) skin's lashing ropes (11)
tui	! shoulder (K)
tuikkaq	! shoulder
tukkaq	! toggle head
tukkumavik	! hotel, inn (N)
tukkuq	! host
tukkuraaq	! throat (pharynx)
tuktaq	! fermented walrus meat rolled in walrus skin
tulimaaq	! rib
tulimaat	! ribs (costae)
tullignaq	! ruddy turnstone (Arenaria interpres)
tullik	! golden plover (Pluvialis dominica)
tullikpak	! black-bellied plover (Squatarola squatarola)
tulugaġnaq	! bank swallow (Riparia riparia), cliff swallow (Petrochelidon pyrrhonota) (lit. resembles raven)
tulugaġnasrugruk	! barn swallow (Hirundo rustica)
tulugaġnauraq	! tree swallow (Iridoproene bicolor)
tulugaq	! raven (Corvus corax)
tulukkam	! asriaq juniper berry (Fructus juniperus) (lit. raven's berry) (K)
tulukkam	! asriat juniper berries (Fructus juniperus), a medicinal drink
tulukkam	! ittuq rusty blackbird (Euphagus carolinus) (lit. like raven)
tulukkam	! nauligaafa parasitic plant on alder roots (Boschniakia rossica) (lit. raven's spear)
tulukkatun	! ittuq rusty blackbird (Euphagus carolinus) (lit. like raven)
tulvik	! (11) fore and aft framing member to which skin is lashed (11)
tumi	! track (trail)
tunŋaviksraq	! place for foundation, place for trusting
tuniglaktuġvik	! offering place (gifts of food set out to secure good luck)
tuniḷḷałiq	! sacrifice (K)
tuniḷḷaqtułiq	! sacrifice
tunu	! back, loin
tunuani	! in behind, to his rear
tunusisaq	! hard covering of small stomach
tunusruk	! rounding of back of head (occipital)
tunusuk	! rounding of back of head (occipital) (K)
tupiksriľiq	! obedience (K)
tupiq	! tent (N)
tupiq	! house (K,q,n) tent (N)
tupit	! facial tattoo lines
tuqłuaq	! chimney (K)
tuqłuk	! windpipe (trachea)
tuqtuqtaq	! timepiece, clock (K)
tuquŋaiñŋaaġman	! before he had died . . .
tuqunayaitchuq	! he would not have died
turraaturaq	! pacific godwit, bartailed godwit (Limosa lapponica)
turvaqsivik	! storage place (K)
tusaapqauraqamigich	! as soon as he heard them
tusaayugaaġiksuaq	! Gospel (lit. what is good to hear) (N)
tusraayugaallautaq	! Gospel (lit. what is good to hear) (K)
tutaaluga	! my grandchild
tutipqich	! stairs, ladder, steps (K)
tutitchiaġa	! my grandchild
tutmaġaa	! stepped on it
tutqiun	! peace (N)
tutqiun	! peace, contentment
tutquqsivik	! storage place (N,q)
tuttu	! caribou (Rangifer arcticus)
tuttugaaġruich	! huge herd of caribou (K)
tuttugaaġruich	! herd of caribou (K)
tuttugaurat	! a few caribou
tuttulik	! boot with caribou sole
tuttuqłuk	! pig (lit. queer deer) (N)
tuttuqpak	! horse (lit. big caribou)
tuttuqpauraġatat	! huge herd of caribou (N)
tuttuvak	! moose (Alces alces)
tuuġniq	! dot
tuugaaq	! walrus tusk, ivory
tuunġaaġruk	! surf scoter (Melanitta perspicallata)
tuunġaq	! helping spirit of a shaman, devil, Satan
tuunġaq	! evil spirit, devil
tuunġaqtalik	! shaman, supplied with a helping spirit, a demon, evil spirit
tuunġaum	! asriaq trailing raspberry (Rubus pendantus) (lit. devil's berry) (K)
tuunġaurisaaq	! a whirlwind (moving horizontally, chiefly across water)
tuuq	! ice chisel (metal point on long pole for making fishing holes in ice)
tuutaq	! lip-plug, labret
tuutlik	! yellow-billed loon (Gavia adamsii)
tuutraq	! ridge beam
tuuyuq	! downy woodpecker (Dendrocopus pubescens)
tuuyuqpak	! hairy woodpecker (Dendrocopus villosus)
tuuyusruġruk	! yellow-shafted flicker (Colaptes auratus borealis)
tuvaaq	! hunter (N)
tuvaaqataiġñiq	! widow, widower, (lit.without a partner) (K)
tuvaaqataitchuq	! bachelor (N)
tuvaaqatiga	! my partner (husband or wife) (N)
tuvaitchiaq	! solid ground
tuvaq	! landlocked ice
tuvaurat	! three stars of sword in constellation Orion (N lit. little hunters K lit. linked ones) (N)
tuyuġmiaq	! guest
tuyuutit	! sent things, mail
uaŋnagruk	! southwesterly wind (N)
uŋalak	! southerly wind
uŋaliagu	! day after tomorrow (K)
uŋaliani	! day before yesterday (K)
uŋallaq	! southerly wind
uŋalut	! cache on poles
uŋuraq	! rabbit drive
ugiihiq	! baldpate of American widgeon (Mareca americanas)
ugisigigaa	! over-excited
ugruŋnaq	! shrew (Sorex cinereus, Sorex tundrensis)
ugruk	! bearded seal (Erignathus barbatus)
ugrulik	! boot with ugruk sole
uiñiq	! lead (open water between landlocked ice and pack ice)
uiga	! my husband
uiksraun	! bridegroom
uitchuq	! opens his eyes
uivaqsaat	! souls of the deceased going around and around (lit. rounding a bend) (N)
uiḷgaġnaaq	! widow (K)
uiḷuaqtaq	! spinster
uiyula	! whirlwind (N)
ukalliq	! snowshoe rabbit, varying hare (Lepus americanus) (N, s)
ukallisugruk	! jackrabbit
ukallisugruk	! Alaska hare (Lepus othus)
ukalliuraq	! snowshoe rabbit, varying hare (Lepus americanus) (K)
ukiaksraq	! autumn, fall
ukialliq	! autumn skin
ukiaq	! autumn, fall
ukiľhaaq	! cloth (N)
ukiuġaġimman	! whenever it is winter
ukiulliq	! winter skin
ukiupak	! this winter, this year (N)
ukiuq	! winter, year
ukiutqik	! two years ago (lit. the second past year)
ukiutqik	! winter before last, two years ago
ukiuvak	! this winter, this year (K)
ukpiġun	! faith
ukpiġun	! faith (N)
ukpiġutaiġupta	! if we no longer have faith
ukpiġutaitkupta	! if we have no faith (never having had faith)
ukpik	! snowly owl (Nyctea scandiaca)
ukpiqsriłiq	! faith (K)
ukpiqsriruaq	! believer, Christian (K)
ukpiqsriruat	! church (lit. believers) (K)
ukpiqtuaguqatisi	! your fellow believers
ukpiqtuaq	! believer, Christian (N)
ukua	! these
ukuaġa	! my sister-in-law, my daughter-in-law
ukuak	! these two
ukuk	! moldy
ukunaŋŋa	! from these (N)
ukunakŋa	! from these (K)
ukunani	! at, in, on these
ukunatun	! like these
ukuniŋa	! (with/about) these
ukunuŋa	! to, for these
ukunuuna	! through, by these
Ulġuniġmiu	! Wainwright villager
uliŋnaak	! fur trousers (extend below calf)
uligruaq	! cover, blanket (N)
uligruitchuq	! steady, patience for fine work
ulimaun	! adze
ulipkaaq	! staggers
ulitchiaq	! cover, blanket (K)
ulivriq	! breaker on ocean (N)
ulu	! woman's knife
uluak	! cheek
uluqpak	! big ulu
uluun	! saw
umŋich	! beard
umiahaaraq	! transportable on a sled (N)
umialiŋnaq	! church elder (N)
umialik	! boat captain
umialik	! king (lit. boat captain) (N)
umialik	! boat captain, rich man, king
umiaq	! skin boat
umiaq	! large skin boat
umiaqpaaraq	! small skin rowboat (N)
umiaqpak	! ship
umiaqtuqti	! whaler
umiŋmak	! muskox (Ovibus moschatus)
umilġuq	! nose (K)
una	! this one
unaaq	! harpoon (pole with metal point to check ice thickness, hooked at the other end)
unaŋŋa	! from far down there (N)
unakŋa	! from far down there (K)
unani	! located far down there
unŋuq	! wart
uniaġaak	! lower jaw
uniaġak	! lower jaw (mandible)
uniat	! sled
unipchaaq	! fable, myth, story (K)
unipkaaq	! fable, myth, story (N)
unna	! far down there, downriver, down at sea
unniqsuqłiun	! promise, covenant (N)
unnuapak	! last night (N)
unnuaq	! night, last night
unnuavak	! last night (K)
unnuŋman	! yesterday (lit. when it was evening) (b)
unnuk	! evening
unuŋa	! toward down there
upinġaaq	! summer
upinġaatqik	! summer before last
upinġaksralliq	! spring skin
upinġaksraq	! spring (lit. potential summer)
upkuaq	! door (N)
uqaaqtuaq	! experience, happening, history, true story
uqaŋŋuaq	! uvula (lit. false tongue) (K)
uqałiq	! word (K)
uqalauraq	! uvula (lit. little tongue) (N)
uqaliq	! word (ki, n)
uqaliq	! word (no, ki)
uqaluk	! word (N)
uqaq	! tongue
uqaqsitaaq	! trial
uqatlaitchuq	!  (K)
uqautchit	! language
uqhaq	! lead
uqpatik	! hips
uqpiŋñaq	! highbush cranberry (Viburnum edule) (K)
uqpik	! willow
uqsi	! appendix (K)
uqsruaġruk	! fuel oil (lubricating oil) (K)
uqsruġaaq	! blubber strips in uqsruq
uqsruġmik-	! rubs with seal oil (as on neck for sore throat)
uqsruġruaq	! fuel oil (lubricating oil) (N)
uqsruġun	! ointment
uqsrukuaqtaq	! doughnut
uqsruqłuk	! kerosene
uqsruqsuŋnitchuq	! smells like seal oil
uqsruqtuuq	! herring
uquutaq	! wind break
urgiiḷgim	! aqargia sharp-tailed grouse (lit. birch ptarmigan) (Pediocetes phasianellus)
urgiiḷik	! birch tree
urraq	! fermented flipper (N)
usiaġuat	! (8) loading platform (8)
usiat	! load (N, q)
usiŋautchiaq	! medium size whale
usriat	! load (K)
usruk	! penis (K)
usuk	! penis (N, q)
usuuraq	! clitoris
utchuk	! vulva
utilgitchuq	! returns again
utkusik	! cooking pot (N)
utkusrik	! cooking pot (K)
utraq	! fermented flipper (K)
uttaaq	! caribou or reindeer skin pants (fur out) (K)
utummak	! palm (N)
utuqqanaat	! old people
uugaq	! tomcod (Boreogadus saida)
uuktuun	! ruler, measuring device
uuktuun	! parable, example
uuliutik	! tenderloins
uuliutik	! back tendon
uuma	! this one's
uumaaġa	! my female cousin (female to female), my girlfriend (female of same age) (K)
uumaŋŋa	! from this (N)
uumaga	! my namesake's wife (N)
uumakŋa	! from this (K)
uumani	! at, in this
uumaq	! green wood
uumatun	! like this
uumiŋa	! (with/about) this one
uumikłiqsuq	! hates (N)
uumman	! heart (K, N)
uumman	! heart
uummaq	! green wood
uumuŋa	! to, for this
uumuuna	! through, by this
uunaqsaun	! heater
uunaqsiivik	! tea kettle
uunŋaiḷaq	! food cooked rare (N)
uupiaġniġiḷaq	! food cooked rare (K)
uuyurat	! eight dried fish linked together
uuyurat	! three stars of sword in constellation Orion (N lit. little hunters K lit. linked ones) (K)
uvaaġniq	! mountain base with gradual slope
uvaŋa	! I, me
uvaŋałhiñaq	! merely me
uvaŋalu	! and me
uvaŋaptauq	! me too
uvaŋaptuuq	! me too
uvaŋauruŋa	! it is I
uvaŋŋa	! from here, hence (N)
uvaguk	! we (two), us
uvagut	! we (pl), us
uvaguttauq	! we (pl.) too
uvakŋa	! from here, hence (K)
uvani	! located here
uviñauyuk	! common scoter (Oidemia nigra)
uviñiq	! skin
uviḷu	! clam, shellfish, bivalve, mussel, snail (K)
uvlaakullunnii	! maybe tomorrow
uvlaakun	! tomorrow (lit. by way of morning)
uvlaakutqik	! day after tomorrow
uvlaapak	! this morning (N)
uvlaaq	! morning
uvlaavak	! this morning (K)
uvluġiam	! anafa shooting star, meterorite (lit. star's feces)
uvluġiaq	! star
uvluiḷgitchuq	! days are getting short again
uvlupak	! today (N)
uvluq	! day
uvluutit	! nest
uvluvak	! today (K)
uvuŋa	! hither, to here
uvuuna	! through here, by way of here
uvva	! here, now, as follows
uvva-aasii	! and then this (introduces a change of subject) (N)
uvva-aasrii	! and then this (introduces a change of subject) (K)
uvva-takku	! because (K)
uyaġak	! stone, rock
uyuġuga	! my nephew, my niece
yaġisrhaq	! knife sheath (n)
yuuqqaq	! snack time, refreshment (K)
aa	! yes (K)

